Ur, Uu, Uu, Xu, Xu, Mm, Mm, Mm, Mm, Mm, Mm, Mm, Mm, Mm, Mm, Mm, Mm, Mm, Hh, Hh, Hh, Gll^Ftr, Gll^Ftr, Gll^Ftr, Re, Gll^Ftr, Gll^Ftr, Gll^Ftr, Re, Gll^Ftr, Gll^Ftr, Gll^Ftr
Uu, Ur, Ur, Uu, Ur, Xu, Xu, Mm, Mm, Mm, Mm, Mm, Mm, Mm, Mm, Mm, Mm, Mm, Hh, Hh, Hh, Gll^Ftr, Gll^Ftr, Gll^Ftr, Re, Gll^Ftr, Re, Re, Chr, Sm, Sm, Gll^Ftr
Xu, Uu, Uu, Ur, 1 Ur, Uu, Uu, Xu, Xu, Mm, Xu, Mm, Xu, Mm, Mm, Mm, Mm, Mm, Hh, Hh, Hh, Gll^Ftr, Gll^Ftr, Gll^Ftr, Re, Re, Sm, Chr, 4 Khs, Chs, Ss, Sm
Mm, Xu, Xu, 2 Uu, Uu, Ur, Ur, Ur, Ur, Xu, Uh, Xu, Uh, Xu, Xu, Mm, Mm, Mm, Hh, Hh, Hh, Gll^Fmw, Re, Re, Gll^Ftr, Sm, Ss, Chs, Chs, Chs, Ss, Ss
Mm, Xu, Xu, Ur, Uu, Ur, Uh, Ur, Ur, Uu, Ur, Uh, Uh, Uh, Uu, Xu, Mm, Mm, Hh, Hh, Gll^Ftr, Gll^Fmw, Re, Gll^Fmw, Gll^Ftr, Sm, Ss, Ss^Vhs, Ww, Ww, Ss, Ss
Mm, Mm, Mm, Xu, Xu, Xu, Xu, Uh, Uu, Ur, Uu, Ur, Ur, Uh, Uu, Xu, Mm, Hh, Hh, Hh, Gll^Ftr, Gll^Fmw, Re, Gll^Fmw, Gll^Ftr, Sm, Ss, Ss, Ww, Ww^Ewf, Ss, Ss
Mm, Mm, Mm, Mm, Mm, Mm, Mm, Xu, Ur, Uu, Uu, Uu, Uu, Ur, Re, Xu, Hh, Hh, Hh, Hh, Gll^Ftr, Gll^Fmw, Re, Gll^Fmw, Gll^Ftr, Sm, Ss, Ww^Ewl, Ww, Ww, Ss^Vhs, Ss
Mm, Mm, Mm, Mm, Mm, Mm, Mm, Xu, Xu, Xu, Xu, Xu, Hh, Uu^Ii, Re, Hh, Hh, Hh, Hh, Gll^Ftr, Gll^Ftr, Gll^Fmw, Re, Gll^Fmw, Sm, Sm, Ss, Ww^Ewl, Ww^Ewl, Ww, Ss, Ss
Mm, Mm, Mm, Mm, Mm, Mm, Mm, Mm, Mm, Mm, Hh, Hh, Re, Re, Hh, Hh, Ker, Cer, Gll^Ftr, Gll^Ftr, Gg^Ve, Gll^Fmw, Re, Re, Re, Ss, Ss, Ww^Ewl, Ww^Vm, Ww, Sm, Gg
Hh, Hh, Hh, Mm, Hh, Mm, Mm, Mm, Hh, Hh, Hh, Hh, Re, Hh, Ker, Cer, Cer, Cer, Gll^Fmw, Gll^Fmw, Re, Re, Gll^Fmw, Gll^Fmw, Sm, Ss^Bw\, Ww^Bw\, Ww^Ewl, Ww, Ww, Ss, Sm
Hh, Hh, Hh, Hh, Hh, Hh, Hh, Hh, Hh, Hh, Hh, Hh, Re, Cer, Cer, Cer, Gll^Fmw, Cer, Re, Re, Gll^Fmw, Gll^Fmw, Sm, Sm, Ss, Ss, Ww, Ww^Bw\, Ss^Bw\, Ss, Sm, Sm
Gll^Ftr, Hh, Gll^Ftr, Hh, Hh, Hh, Hh, Hh, Hh, Hh, Gll^Ftr, Gll^Ftr, Gll^Ftr, Re, Cer, Gll^Ftr, Gll^Fmw, Re, Gll^Fmw, Gll^Fmw, Gll^Ftr, Gll^Ftr, Sm, Ss, Ww, Ww, Ss, Ss, Sm, Re, Gll^Fmw, Gll^Ftr
Gll^Ftr, Gll^Ftr, Gll^Ftr, Gll^Ftr, Gll^Ftr, Hh, Hh, Hh, Gll^Ftr, Gll^Ftr, Gll^Ftr, Gg^Ve, Gll^Ftr, Re, Re, Gll^Fmw, Re, Re, Gll^Fmw, Gll^Ftr, Gll^Ftr, Sm, Ss, Ss, Ww, Ss, Sm, Sm, Gll^Fmw, Re, Gll^Fmw, Gll^Ftr
Gll^Ftr, Gll^Ftr, Gll^Ftr, Gll^Ftr, Gll^Ftr, Gll^Ftr, Gg^Ve, Gll^Ftr, Gll^Ftr, Gll^Ftr, Gll^Ftr, Gll^Ftr, Gll^Ftr, Gll^Fmw, Re, Re, Gll^Fmw, Gg^Ve, Gll^Ftr, Gll^Ftr, Gll^Ftr, Sm, Ss, Ww, Ss, Ss, Sm, Sm, Gll^Fmw, Re, Gll^Fmw, Gll^Ftr
Gll^Ftr, Gll^Ftr, Gll^Ftr, Gll^Ftr, Gll^Ftr, Gll^Ftr, Gll^Ftr, Gll^Ftr, Gll^Fmw, Gll^Ftr, Gll^Ftr, Gll^Ftr, Gll^Ftr, Gll^Fmw, Re, Gll^Fmw, Gll^Ftr, Gll^Ftr, Gll^Ftr, Gll^Ftr, Sm, Sm, Ss, Ww, Ss, Sm, Gll^Ftr, Gll^Ftr, Gll^Fmw, Re, Gll^Fmw, Gll^Ftr
Gll^Ftr, Gll^Ftr, Gll^Ftr, Gll^Ftr, Gll^Ftr, Gll^Ftr, Gll^Fmw, Gll^Fmw, Re, Gll^Fmw, Gll^Fmw, Gll^Ftr, Gg^Ve, Gll^Fmw, Re, Gll^Fmw, Gll^Ftr, Gll^Ftr, Sm, Sm, Ss, Ss, Ww, Ww, Ss, Sm, Gll^Ftr, Gll^Ftr, Gll^Fmw, Re, Gll^Fmw, Gll^Ftr
Gll^Ftr, Gll^Ftr, Gll^Ftr, Gll^Ftr, Gll^Fmw, Gll^Fmw, Re, Re, Gll^Fmw, Re, Re, Gll^Fmw, Gll^Fdf, Gll^Fmw, Re, Gll^Fmw, Gll^Ftr, Gll^Ftr, Sm, Ss, Ww, Ww, Ss, Ss, Sm, Sm, Gll^Ftr, Gll^Ftr, Gll^Fmw, Re, Gll^Fmw, Gll^Ftr
Gll^Ftr, Gll^Ftr, Gll^Fmw, Gll^Fmw, Re, Re, Gll^Fmw, Gll^Fmw, Gll^Ftr, Gll^Fmw, Gll^Fmw, Re, Re, Gll^Fmw, Re, Gll^Fmw, Gll^Ftr, Gll^Ftr, Sm, Ss, Ww, Ss, Sm, Sm, Gll^Ftr, Gll^Ftr, Gll^Fmw, Gll^Fmw, Re, Re, Gll^Fmw, Gll^Ftr
Gll^Fmw, Gll^Fmw, Re, Re, Gll^Fmw, Gll^Fmw, Sm, Sm, Sm, Gll^Ftr, Gll^Ftr, Gll^Fmw, Gll^Fmw, Re, Re, Gll^Fmw, Gll^Ftr, Sm, Ss, Ss, Ww, Ss, Sm, Gll^Ftr, Gll^Fmw, Gll^Fmw, Re, Re, Gll^Fmw, Gll^Fmw, Gll^Ftr, Gg
Re, Re, Gll^Fmw, Gll^Fmw, Gll^Ftr, Sm, Ww^Vm, Ww^Ewl, Ww^Ewl, Sm, Gll^Ftr, Gg^Ve, Gll^Fmw, Gll^Fmw, Re, Gll^Fmw, Gll^Ftr, Sm, Ss, Ww, Ss, Ss, Sm, Gll^Ftr, Gll^Fmw, Re, Gll^Fmw, Gll^Fmw, Gll^Ftr, Gll^Ftr, Gll^Ftr, Gll^Ftr
Gll^Ftr, Gll^Fmw, Gll^Ftr, Gll^Ftr, Sm, Sm, Ww^Ewl, Ww, Ww^Ewl, Sm, Gll^Ftr, Gll^Ftr, Gll^Fmw, Re, Re, Gll^Fmw, Sm, Sm, Ss, Ww, Ss, Sm, Gll^Ftr, Gll^Ftr, Gll^Fmw, Re, Gll^Fmw, Gll^Ftr, Hhd, Hhd, Hhd, Gll^Ftr
Gll^Ftr, Gll^Ftr, Gll^Ftr, Gll^Ftr, Sm, Ww^Ewl, Ww, Ww, Ww^Ewl, Sm, Gll^Ftr, Gll^Ftr, Gll^Ftr, Gg^Ve, Gll^Fmw, Re, Re, Ss, Ww, Ww, Ss, Sm, Gll^Fmw, Gll^Fmw, Re, Re, Gd^Vo, Gll^Ftr, Hhd, Hhd, Mm, Hhd
Gll^Ftr, Gll^Ftr, Sm, Sm, Ww^Ewl, Ww^Ewl, Ww, Ww^Ewl, Sm, Sm, Gll^Ftr, Gll^Ftr, Gll^Ftr, Gll^Fmw, Sm, Sm, Re, Ss, Ww, Ss, Sm, Sm, Re, Re, Gll^Fmw, Gll^Fmw, Hhd, Hhd, Mm, Mm, Mm, Mm
Gll^Ftr, Sm, Ww^Ewl, Ww^Ewl, Ww, Ww, Ww^Ewl, Ww^Ewl, Sm, Gll^Ftr, Gll^Ftr, Gll^Ftr, Gll^Ftr, Sm, Ss, Ss, Ww, Ww^Bw\, Ss^Bw\, Ss, Sm, Gll^Fmw, Re, Gll^Fmw, Gll^Ftr, Gll^Ftr, Hhd, Mm, Mm, Mm, Mm, Mm
Sm, Sm, Ww^Ewl, Ww, Ww^Ewl, Ww^Ewl, Sm, Sm, Gll^Ftr, Gll^Ftr, Gll^Ftr, Gll^Ftr, Gg^Ve, Sm, Ss, Ww, Ss, Ss, Sm, Re, Re, Re, Gll^Fmw, Gll^Fmw, Hhd, Hhd, Mm, Mm, Mm, Mm, Mm, Mm
Sm, Ww^Ewl, Ww^Ewl, Ww, Ww^Ewl, Sm, Gll^Ftr, Gll^Ftr, Gll^Ftr, Gll^Ftr, Gll^Ftr, Gll^Ftr, Sm, Sm, Ss, Ww, Ss, Sm, Gll^Fmw, Gll^Fmw, Re, Gll^Fmw, Gll^Ftr, Hhd, Mm, Mm, Mm, Mm, Mm, Mm, Mm, Mm
Ww^Ewl, Ww^Ewl, Ww, Ww, Ww^Ewl, Sm, Gll^Ftr, Gll^Ftr, Gll^Ftr, Gll^Ftr, Sm, Sm, Ss, Ss, Ww, Ww, Ss, Sm, Gll^Fmw, Gll^Fmw, Re, Re, Hhd, Hhd, Xu, Mm, Mm, Mm, Mm, Mm, Mm, Mm
Ww, Ww, Ww^Ewl, Ww^Ewl, Sm, Sm, Gll^Ftr, Gll^Ftr, Sm, Sm, Ss, Ss, Ww, Ww, Ss, Ss, Sm, Sm, Gll^Fmw, Re, Gll^Ftr, Gll^Ftr, Hhd, Hhd, Ur, Xu, Xu, Mm, Mm, Mm, Mm, Mm
Ww, Ww^Vm, Sm, Sm, Gll^Ftr, Gll^Ftr, Gll^Ftr, Sm, Ss, Ss, Ww, Ww, Ss, Ss, Sm, Sm, Gll^Fmw, Gll^Fmw, Gll^Fmw, Re, Gll^Ftr, Hhd, Mm, Ur, Ur, Ur, Ur, Xu, Mm, Mm, Mm, Mm
Ww^Ewl, Ww^Ewl, Sm, Gll^Ftr, Gll^Ftr, Gll^Ftr, Sm, Sm, Ss, Ww, Ss, Ss, Sm, Sm, Gll^Fmw, Gll^Fmw, Gll^Ftr, Gll^Ftr, Gll^Fmw, Re, Gll^Ftr, Hhd, Mm, Xu, Xu, Ur, Ur, Xu, Mm, Mm, Mm, Mm
Sm, Sm, Gll^Ftr, Gll^Ftr, Sm, Sm, Ss, Ss, Ww, Ww, Ss, Sm, Gll^Fmw, Gll^Fmw, Gll^Ftr, Gd^Vo, Gll^Ftr, Gll^Ftr, Gll^Fmw, Re, Hhd, Gd^Vo, Mm, Mm, Xu, Ur, Ur, Xu, Xu, Mm, Xu, Xu
Gll^Ftr, Gll^Ftr, Gll^Ftr, Gll^Ftr, Sm, Ss, Ww, Ww, Ss, Ss, Sm, Sm, Gll^Fmw, Gll^Ftr, Gll^Ftr, Gll^Ftr, Gll^Ftr, Gll^Ftr, Hhd, Re, Hhd, Cfr, Mm, Mm, Mm, Xu, Ur, Ur, Ur, Xu, Xu, Xu
Gll^Ftr, Gll^Ftr, Gll^Ftr, Sm, Ss, Ss, Ww, Ss, Sm, Sm, Gll^Fmw, Gll^Fmw, Gll^Ftr, Gll^Ftr, Hhd, Hhd, Hhd, Hhd, Hhd, Hhd, Cfr, Cfr, Cfr, Mm, Mm, Xu, Xu, Ur, Ur, Ur, Ur, Xu
Gll^Ftr, Gll^Ftr, Gll^Ftr, Sm, Ss, Ww, Ww, Ss, Ss, Sm, Gll^Ftr, Gll^Ftr, Hhd, Hhd, Hhd, Hhd, Mm, Mm, Mm, Cfr, Mm, 3 Kfr, Cfr, Mm, Mm, Mm, Mm, Xu, Xu, Ur, Ur, Ur
Gll^Ftr, Gll^Ftr, Gll^Ftr, Sm, Sm, Ss, Ww, Ww, Ss, Sm, Gll^Ftr, Hhd, Hhd, Hhd, Mm, Mm, Mm, Mm, Mm, Mm, Mm, Mm, Mm, Cfr, Mm, Mm, Mm, Xu, Xu, Xu, Xu, Ur
Gll^Ftr, Gll^Ftr, Gll^Ftr, Gll^Ftr, Sm, Ss, Ww, Ss, Sm, Sm, Hhd, Hhd, Mm, Mm, Mm, Mm, Mm, Mm, Mm, Mm, Mm, Mm, Mm, Mm, Mm, Mm, Mm, Mm, Xu, Xu, Xu, Xu
Gll^Ftr, Gll^Ftr, Gll^Ftr, Gll^Ftr, Sm, Ss, Ww, Ss, Sm, Gll^Ftr, Hhd, Hhd, Hhd, Mm, Mm, Mm, Mm, Mm, Mm, Mm, Mm, Mm, Mm, Mm, Mm, Mm, Mm, Mm, Gg, Xu, Mm, Xu
