Xur, Ur, Ur, Ur, Xur, Ur, Xur, Uh, Uhe, Uh, Uh, Uh, Uh, Uh, Ur, Uh, Uh, Uh, Uh, Uh, Uh, Uh, Uh, Uh, Ur, Ur, Ur, Ur, Uue, Uue, Uue, Uue, Uue, Uue, Uue, Ur, Ur, Ur
Xur, Xur, Xur, Ur, Ur, Xur, Uhe, Uhe, Uh, Uh, Uh, Uh, Uh, Uh, Ur, Uh, Uh, Uh, Uh, Uh, Uh, Uh, Ur, Uh, Ur, Ur, Uue, Uue, Uue, Uue, Uhe^Qhh, Uhe^Qhh, Uhe^Qhh, Uue, Uue, Uue, Uue, Ur
Ur, Xur, Xur, Uhe, Ur, Ur, Ur, Ur, Ur, Uh, Uh, Uh, Uh, Uh, Ur, Uh, Uh, Uh, Uh, Uh, Ur, Ur, Ur, Ur, Ur, Uue, Uue, Uue, Uhe^Qhh, Uhe^Qhh, Xu^Qhh, Xu^Qhh, Xu^Qhh, Uhe^Qhh, Uhe^Qhh, Uue, Uue, Ur
Uhe, Uhe, Uhe, Uu^Vu, Ur, Tb^Tf, Tb^Tf, Tb^Tf, Ur, Ur, Ur, Uh, Uh, Uh, Ur, Uh, Uh, Uh, Uh, Uu, Ur, Ur, Ur, Uu, Ur, Uue, Uhe^Qhh, Uhe^Qhh, Xu^Qhh, Xu^Qhh, Xu^Qhh, Xu^Qhh, Xu^Qhh, Xu^Qhh, Xu^Qhh, Uhe^Qhh, Uue, Uue
Uhe^Qhh, Uhe^Qhh, Uhe^Qhh, Tb^Tf, Uh, Uh, Tb^Tf, Uu, Tb^Tf, Ur, Ur, Cvr, Cvr, Cvr, 4 Kvr, Cvr, Cvr, Cvr, Ur, Ur, Uu, Tb^Tf, Tb^Tf, Tb^Tf, Ur, Uue, Uhe^Qhh, Xu^Qhh, Xu^Qhh, Xu^Qhh, Xu^Qhh, Xu^Qhh, Xu^Qhh, Xu^Qhh, Uhe^Qhh, Uhe^Qhh, Uue, Uue
Uhe^Qhh, Qxua^Qhu, Qxua^Qhu, Uhe^Qhh, Uu, Uu, Uh, Uh, Uu^Vu, Uu, Ur, Ur, Ur, Ur, Ur, Ur, Ur, Ur, Xot^Qhh, Ur, Xot^Qhh, Uu, Uu, Tb^Tf, Ur, Uue, Uhe^Qhh, Xu^Qhh, Xu^Qhh, Xu^Qhh, Xu^Qhh, Xu^Qhh, Xu^Qhh, Xu^Qhh, Uhe^Qhh, Uhe^Qhh, Uue, Uue
Ur, Uhe^Qhh, Qxua^Qhu, Uhe^Qhh, Uu^Vu, Uu, Ur, Tb^Tf, Uh, Uh, Uh, Tb^Tf, Tb^Tf, Ur, Uu^Vu, Tb^Tf, Xot^Qhh, Xot^Qhh, Urb^Qhu, Urb^Qhu, Urb^Qhu, Xot^Qhh, Xot^Qhh, Uu, Ur, Uue, Uue, Uhe^Qhh, Uhe^Qhh, Uhe^Qhh, Uhe^Qhh, Xu^Qhh, Xu^Qhh, Xu^Qhh, Uhe^Qhh, Uhe^Qhh, Uue, Uue
Qxua^Qhu, Qxua^Qhu, Qxua^Qhu, Tb^Tf, Uu, Tb^Tf, Uu, Uu, Tb^Tf, Uu, Uh, Uh, Uu, Uu, Ur, Xot^Qhh, Urb^Qhu, Urb^Qhu, Xoa^Qhh, Xoa^Qhh, Xoa^Qhh, Urb^Qhu, Urb^Qhu, Xot^Qhh, Xot^Qhh, Ur, Ur, Uue, Uue, Uhe^Qhh, Uhe^Qhh, Xu^Qhh, Xu^Qhh, Xu^Qhh, Uhe^Qhh, Uhe^Qhh, Uue, Uue
Uhe, Qxua^Qhu, Qxua^Qhu, Tb^Tf, Tb^Tf, Uue^Qhh, Uue^Qhh, Uue^Qhh, Tb^Tf, Tb^Tf, Uu, Tb^Tf, Xot^Qhh, Xot^Qhh, Ur, Urb^Qhu, Xoa^Qhh, Xoa^Qhh, Urb^Qhu, Urb^Qhu, Urb^Qhu, Xoa^Qhh, Xoa^Qhh, Urb^Qhu, Ur, Ur, Xot^Qhh, Ur, Ur, Uue, Uue, Uhe^Qhh, Uhe^Qhh, Uhe^Qhh, Uu^Vu, Uue, Uue, Ur
Qxua^Qhu, Qxua^Qhu, Uhe^Qhh, Uhe^Qhh, Uu, Uue^Qhh, Uue^Qhh, Tb^Tf, Uue, Uue, Xot^Qhh, Xot^Qhh, Urb^Qhu, Urb^Qhu, Xoa^Qhh, Ur, Ur, Urb^Qhu, Xos^Qhh, Xos^Qhh, Xos^Qhh, Urb^Qhu, Ur, Ur, Xoa^Qhh, Urb^Qhu, Urb^Qhu, Xot^Qhh, Xot^Qhh, Ur, Ur, Uue, Uue, Uue, Uue, Uue, Ur, Ur
Uhe, Qxua^Qhu, Uhe^Qhh, Uu, Uue, Tb^Tf, Uu, Uu^Vu, Xot^Qhh, Xot^Qhh, Urb^Qhu, Urb^Qhu, Xoa^Qhh, Xoa^Qhh, Urb^Qhu, Urb^Qhu, Xos^Qhh, Ur, Iwc, Iwc, Iwc, Ur, Xos^Qhh, Urb^Qhu, Urb^Qhu, Xoa^Qhh, Xoa^Qhh, Urb^Qhu, Urb^Qhu, Xot^Qhh, Xot^Qhh, Ur, Ur, Ur, Ur, Ur, Ur, Ur
Qxua^Qhu, Qxua^Qhu, Uhe^Qhh, Uu, Tb^Tf, Uu, Xot^Qhh, Xot^Qhh, Urb^Qhu, Urb^Qhu, Xoa^Qhh, Xoa^Qhh, Urb^Qhu, Urb^Qhu, Xos^Qhh, Xos^Qhh, Xos^Qhh, Xos^Qhh, Xos^Qhh, Ur, Xos^Qhh, Xos^Qhh, Xos^Qhh, Xos^Qhh, Xos^Qhh, Urb^Qhu, Urb^Qhu, Xoa^Qhh, Xoa^Qhh, Urb^Qhu, Urb^Qhu, Xot^Qhh, Xot^Qhh, Ur, Ur, Ur, Ur, Ur
Uhe^Qhh, Qxua^Qhu, Uhe^Qhh, Ur, Ur, Xot^Qhh, Urb^Qhu, Urb^Qhu, Xoa^Qhh, Ur, Urb^Qhu, Urb^Qhu, Urb^Qhu, Urb^Qhu, Urb^Qhu, Urb^Qhu, Urb^Qhu, Urb^Qhu, Ur, Ur, Urb^Qhu, Urb^Qhu, Urb^Qhu, Urb^Qhu, Urb^Qhu, Urb^Qhu, Urb^Qhu, Urb^Qhu, Urb^Qhu, Ur, Xoa^Qhh, Urb^Qhu, Urb^Qhu, Ur, Xot^Qhh, Ur, Ur, Ur
Ur, Uhe^Qhh, Xot^Qhh, Xot^Qhh, Urb^Qhu, Urb^Qhu, Xoa^Qhh, Xoa^Qhh, Xoa^Qhh, Xoa^Qhh, Xoa^Qhh, Xoa^Qhh, Xoa^Qhh, Xoa^Qhh, Xoa^Qhh, Xoa^Qhh, Xoa^Qhh, Xoa^Qhh, Ur, Xoa^Qhh, Xoa^Qhh, Xoa^Qhh, Xoa^Qhh, Xoa^Qhh, Xoa^Qhh, Xoa^Qhh, Xoa^Qhh, Xoa^Qhh, Xoa^Qhh, Xoa^Qhh, Xoa^Qhh, Xoa^Qhh, Xoa^Qhh, Urb^Qhu, Urb^Qhu, Xot^Qhh, Xot^Qhh, Ur
Ur, Xot^Qhh, Ur, Urb^Qhu, Urb^Qhu, Urb^Qhu, Urb^Qhu, Urb^Qhu, Urb^Qhu, Urb^Qhu, Urb^Qhu, Urb^Qhu, Urb^Qhu, Urb^Qhu, Urb^Qhu, Urb^Qhu, Urb^Qhu, Urb^Qhu, Urb^Qhu, Urb^Qhu, Urb^Qhu, Urb^Qhu, Urb^Qhu, Urb^Qhu, Urb^Qhu, Urb^Qhu, Urb^Qhu, Urb^Qhu, Urb^Qhu, Urb^Qhu, Urb^Qhu, Urb^Qhu, Urb^Qhu, Urb^Qhu, Urb^Qhu, Urb^Qhu, Xot^Qhh, Xot^Qhh
Ur, Ur, Ur, Xot^Qhh, Xot^Qhh, Xot^Qhh, Xot^Qhh, Ur, Xot^Qhh, Xot^Qhh, Xot^Qhh, Xot^Qhh, Xot^Qhh, Xot^Qhh, Xot^Qhh, Xot^Qhh, Xuf^Qhh, Xuf^Qhh, Xuf^Qhh, Xot^Qhh, Xot^Qhh, Xot^Qhh, Xot^Qhh, Xot^Qhh, Xot^Qhh, Xot^Qhh, Ur, Xot^Qhh, Xot^Qhh, Xot^Qhh, Xot^Qhh, Xot^Qhh, Xot^Qhh, Xot^Qhh, Xot^Qhh, Ur, Ur, Ur
Ur, Ur, Ur, Uu^Vu, Ur, Cfr, Uu, Ur, Ur, Tb^Tf, Tb^Tf, Tb^Tf, Wwf^Qhuf, Tb^Tf, Tb^Tf, Tb^Tf, Wwf^Qhuf, Ww^Qhuf, Tb^Tf, Uu, Uu, Ur, Ur, Ur, Ur, Ur, Ur, Ur, Uhe^Qhh, Uhe^Qhh, Uhe^Qhh, Uhe^Qhh, Uhe^Qhh, Ur, Uhe^Qhh, Ur, Ur, Ur
Ur, Ur, Uhe^Qhh, Ur, Ur, Cfr, Ur, Uu, Ur, Uu, Uh, Wwf^Qhuf, Ww^Qhuf, Uu, Uue^Qhuf, Uue^Qhuf, Ww^Qhuf, Wwf^Qhuf, Uh, Tb^Tf, Uu, Ur, Cfr, Ur, Uh, Ur, Uu^Vu, Uhe^Qhh, Qxua^Qhu, Qxua^Qhu, Qxua^Qhu, Qxua^Qhu, Qxua^Qhu, Uhe^Qhh, Qxua^Qhu, Uhe^Qhh, Ur, Ur
Ur, Uhe^Qhh, Qxua^Qhu, Uhe^Qhh, Cfr, Uu, Uu, Tb^Tf, Uu^Vu, Ur, Uu, Tb^Tf, Wwf^Qhuf, Wwf^Qhuf, Uh, Uh, Uh, Ww^Qhuf, Uh, Uu, Tb^Tf, Ur, Cfr, Cfr, Uh, Ur, Uhe^Qhh, Uhe^Qhh, Qxua^Qhu, Qxua^Qhu, Qxua^Qhu, Qxua^Qhu, Qxua^Qhu, Qxua^Qhu, Qxua^Qhu, Uu^Vu, Uhe^Qhh, Ur
Ur, Uhe^Qhh, Qxua^Qhu, Uhe^Qhh, Ur, Ur, Uu, Tb^Tf, Uu, Ur, Tb^Tf, Tb^Tf, Uh, Uh, Wwf^Qhuf, Ww^Qhuf, Ww^Qhuf, Uh, Tb^Tf, Tb^Tf, Tb^Tf, Uu^Vu, Ur, Ur, Uh, Ur, Uh, Qxua^Qhu, Uhe^Qhh, Qxua^Qhu, Qxua^Qhu, Qxua^Qhu, Uhe^Qhh, Qxua^Qhu, Qxua^Qhu, Qxua^Qhu, Uhe^Qhh, Ur
Ur, Uhe^Qhh, Qxua^Qhu, Uhe^Qhh, Tb^Tf, Ur, Ur, Uu, Uu, Tb^Tf, Ur, Uu, Uh, Uu^Vu, Uh, Uh, Uh, Uh, Ur, Ur, Ur, Uu, Tb^Tf, Ur, Ur, Uh, Uh, Uhe^Qhh, Ur, Uhe^Qhh, Uhe^Qhh, Uhe^Qhh, Ur, Uhe^Qhh, Uhe^Qhh, Qxua^Qhu, Uhe^Qhh, Xue
Uhe, Qxua^Qhu, Qxua^Qhu, Uhe^Qhh, Uu, Tb^Tf, Uue, Tb^Tf, Tb^Tf, Tb^Tf, Uu, Uu, Tb^Tf, Tb^Tf, Uu, Uu, Tb^Tf, Tb^Tf, Uh, Uh, Ur, Tb^Tf, Uu, Tb^Tf, Ur, Ur, Ur, Uh, Uh, Ur, Ur, Ur, Ur, Ur, Uu^Vu, Uhe^Qhh, Xue, Xue
Uhe, Qxua^Qhu, Uhe^Qhh, Tb^Tf, Uu, Uu, Ur, Uu, Tb^Tf, Tb^Tf, Tb^Tf, Ur, Cfr, Cfr, Cfr, Cfr, Tb^Tf, Ur, Uu, Uh, Uh, Tb^Tf, Uh, Uh, Uh, Ur, Ur, Ur, Ur, Uh, Uh, Ur, Ur, Ur, Ce, Ce, Ce, Xue
Ur, Qxua^Qhu, Qxua^Qhu, Uhe^Qhh, Tb^Tf, Tb^Tf, Ur, Tb^Tf, Tb^Tf, Tb^Tf, Ur, Cfr, Cfr, Cfr, 3 Kfr, Ur, Cfr, Cfr, Uu, Uu, Uu, Uu, Uu, Uh, Ur, Uh, Uh, Ur, Ur, Uh, Ur, Uh, Uh, Uh, Ce, 1 Ke, Ce, Xue
Ur, Uhe^Qhh, Qxua^Qhu, Uhe^Qhh, Ur, Ur, Tb^Tf, Uu^Vu, Tb^Tf, Ur, Xu^Qhh, Xu^Qhh, Xu^Qhh, Xu^Qhh, Xu^Qhh, Ur, Ur, Ur, Ur, Tb^Tf, Ur, Ur, Tb^Tf, Uu^Vu, Uh, Uhe, Uhe, Uh, Uh, Ur, Ur, Ur, Ce, Ur, Ur, Ce, Ur, Ur
Ur, Uhe^Qhh, Qxua^Qhu, Uhe^Qhh, Ur, Ur, Xu^Qhh, Xu^Qhh, Xu^Qhh, Xu^Qhh, Xu^Qhh, Xu^Qhh, Xu^Qhh, Xu^Qhh, Xu^Qhh, Xu^Qhh, Xu^Qhh, Ur, Ur, Ur, Ur, Ur, Uhe, Uhe, Uhe, Uhe, Uhe, Uh, Uh, Uh, Uu^Vu, Ce, 2 Ke, Ce, Xue, Ur, Ur, Ur
Ur, Uhe^Qhh, Uhe^Qhh, Uhe^Qhh, Ur, Ur, Xu^Qhh, Xu^Qhh, Xu^Qhh, Xu^Qhh, Xu^Qhh, Xu^Qhh, Xu^Qhh, Xu^Qhh, Xu^Qhh, Xu^Qhh, Xu^Qhh, Xu^Qhh, Ur, Ur, Ur, Uhe, Uhe, Uhe, Uhe, Uhe, Uhe, Uhe, Uhe, Uhe, Uhe, Ce, Ce, Ce, Xue, Xue, Ur, Ur
Ur, Ur, Ur, Ur, Ur, Ur, Ur, Xu^Qhh, Xu^Qhh, Xu^Qhh, Xu^Qhh, Xu^Qhh, Xu^Qhh, Xu^Qhh, Xu^Qhh, Xu^Qhh, Xu^Qhh, Xu^Qhh, Ur, Ur, Ur, Uhe, Uhe, Uhe, Uhe, Uhe, Uhe, Uhe, Uhe, Uhe, Xue, Xue, Xue, Xue, Xue, Xue, Xue, Ur
