Dd^Ftd, Dd^Ftd, Dd^Ftd, Dd^Ftd, Dd^Ftd, Dd^Ftd, Dd^Ftd, Dd^Ftd, Dd^Ftd, Dd^Ftd, Dd^Ftd, Dd^Ftd, Dd^Ftd, Dd^Ftd, Dd^Ftd, Dd^Ftd, Dd^Ftd, Dd^Ftd, Dd^Ftd, Dd^Ftd, Dd^Ftd, Dd^Ftd
Re, Dd^Ftd, Re, Dd^Ftd, Re, Dd^Ftd, Dd^Ftd, Dd^Ftd, Gs^Ftp, Gs^Ftp, Dd^Ftd, Dd^Ftd, Gs^Ftp, Dd^Ftd, Gs^Ftp, Dd^Ftd, Dd^Ftd, Dd^Ftd, Dd^Ftd, Dd^Ftd, Dd^Ftd, Dd^Ftd
Dd^Ftd, Re, Cdr, Re, Dd^Vdt, Re, Re, Dd^Ftd, Gs^Ftp, Gs^Ftp, Gs^Ftp, Gs^Ftp, Dd^Ftd, Gs^Ftp, Gs^Ftp, Dd^Ftd, Gs^Ftp, Gs^Ftp, Gs^Ftp, Dd^Ftd, Dd^Ftd, Dd^Ftd
Dd^Ftd, Dd^Ftd, Cdr, Dd^Ftd, Cdr, Dd^Ftd, Dd^Ftd, Re, Re, Gs^Ftp, Gs^Ftp, Gs^Ftp, Gs^Ftp, Gs^Ftp, Gs^Ftp, Gs^Ftp, Gs^Ftp, Rp^Vhcr, Gs^Ftp, Gs^Ftp, Gs^Ftp, Dd^Ftd
Dd^Ftd, Dd^Ftd, Dd^Vdt, Dd^Ftd, Cdr, Cdr, Cdr, Rd, Re, Gs, Gs, Gs, Gs, Gs, Gs, Gs^Ftp, Dd^Ftd, Gs^Ftp, Gs^Ftp, Gs^Ftp, Gs^Ftp, Dd^Ftd
Dd^Ftd, Dd^Ftd, Dd^Ftd, Cdr, Dd^Ftd, 2 Kdr, Rd, Rd, Re, Re, Re, Re, Re, Re, Re, Gs, Gs, Gs^Ftp, Gs^Ftp, Gs^Ftp, Gs^Ftp, Dd^Ftd
Dd^Ftd, Dd^Ftd, Dd^Ftd, Dd^Ftd, Dd^Ftd, Rd, Re, Re, Hh^Qhh, Rp^Vhcr, Hh^Qhh, Hh^Qhh, Hh^Qhh, Hh^Qhh, Hh^Qhh, Re, Re, Gs, Gs, Gs^Ftp, Gs^Ftp, Dd^Ftd
Md, Dd^Ftd, Hh^Qhh, Hh^Qhh, Hh^Qhh, Re, Hh^Qhh, Hh^Qhh, Md^Qhh, Hh^Qhh, Md^Qhh, Hh^Qhh, Hh^Qhh, Hh^Qhh, Hh^Qhh, Hh^Qhh, Hh^Qhh, Re, Gs, Gs^Ftp, Gs^Ftp, Dd^Ftd
Hh^Qhh, Hh^Qhh, Mm^Qhh, Md^Qhh, Hh^Qhh, Re, Hh^Qhh, Md^Qhh, Md^Qhh, Md^Qhh, Md^Qhh, Hh^Qhh, Hh^Qhh, Hh^Qhh, Hh^Qhh, Hh^Qhh, Hh^Qhh, Re, Gs, Gs^Ftp, Hh^Qhh, Hh^Qhh
Mm^Qhh, Mm^Qhh, Mm^Qhh, Mm^Qhh, Hh^Qhh, Re, Hh^Qhh, Md^Qhh, Mm^Qhh, Md^Qhh, Mm^Qhh, Md^Qhh, Md^Qhh, Hh^Qhh, Hh^Qhh, Hh^Qhh, Hh^Qhh, Re, Gs, Hh^Qhh, Md^Qhh, Md^Qhh
Mm^Qhh, Mm^Qhh, Mm^Qhh, Md^Qhh, Hh^Qhh, Re, Hh^Qhh, Mm^Qhh, Md^Qhh, Mm^Qhh, Mm^Qhh, Mm^Qhh, Md^Qhh, Md^Qhh, Hh^Qhh, Hh^Qhh, Re, Re, Gs, Hh^Qhh, Md^Qhh, Md^Qhh
Mm^Qhh, Mm^Qhh, Md^Qhh, Md^Qhh, Hh^Qhh, Re, Hh^Qhh, Md^Qhh, Mm^Qhh, Mm^Qhh, Rp^Vhcr, Mm^Qhh, Md^Qhh, Md^Qhh, Hh^Qhh, Hh^Qhh, Re, Gs, Hh^Qhh, Hh^Qhh, Md^Qhh, Md^Qhh
Mm^Qhh, Md^Qhh, Mm^Qhh, Md^Qhh, Hh^Qhh, Re, Hh^Qhh, Md^Qhh, Md^Qhh, Mm^Qhh, Md^Qhh, Md^Qhh, Md^Qhh, Md^Qhh, Hh^Qhh, Hh^Qhh, Re, Gs, Hh^Qhh, Md^Qhh, Md^Qhh, Md^Qhh
Mm^Qhh, Mm^Qhh, Md^Qhh, Md^Qhh, Hh^Qhh, Re, Re, Rp^Vhcr, Md^Qhh, Md^Qhh, Mm^Qhh, Mm^Qhh, Md^Qhh, Hh^Qhh, Hh^Qhh, Hh^Qhh, Re, Gs, Hh^Qhh, Md^Qhh, Md^Qhh, Md^Qhh
Hh, Mm^Qhh, Mm^Qhh, Md^Qhh, Md^Qhh, Hh^Qhh, Re, Hh^Qhh, Mm, Md^Qhh, Mm^Qhh, Mm^Qhh, Rp^Vhcr, Hh^Qhh, Hh^Qhh, Re, Gs, Gs, Md^Qhh, Md^Qhh, Md^Qhh, Gg
Mm^Qhh, Mm^Qhh, Md^Qhh, Md^Qhh, Md^Qhh, Hh^Qhh, Re, Hh^Qhh, Md^Qhh, Md^Qhh, Mm^Qhh, Hh^Qhh, Hh^Qhh, Hh^Qhh, Re, Re, Gs, Hh^Qhh, Md^Qhh, Md^Qhh, Hh^Qhh, Hh^Qhh
Mm^Qhh, Md^Qhh, Md^Qhh, Mm^Qhh, Mm^Qhh, Hh^Qhh, Re, Hh^Qhh, Md^Qhh, Mm^Qhh, Hh^Qhh, Hh^Qhh, Hh^Qhh, Hh^Qhh, Re, Gs, Hh^Qhh, Hh^Qhh, Md^Qhh, Md^Qhh, Md^Qhh, Hh^Qhh
Hh^Qhh, Mm^Qhh, Mm^Qhh, Mm^Qhh, Mm^Qhh, Hh^Qhh, Re, Hh^Qhh, Mm^Qhh, Md^Qhh, Hh^Qhh, Hh^Qhh, Re, Re, Gs, Gs, Hh^Qhh, Md^Qhh, Md^Qhh, Md^Qhh, Md^Qhh, Hh^Qhh
Hh^Qhh, Hh^Qhh, Hh^Qhh, Hh^Qhh, Hh^Qhh, Hh^Qhh, Re, Hh^Qhh, Hh^Qhh, Hh^Qhh, Re, Re, Gs, Gs, Hh^Qhh, Hh^Qhh, Md^Qhh, Md^Qhh, Md^Qhh, Md^Qhh, Hh^Qhh, Hh^Qhh
Hhd^Qhh, Hh^Qhh, Hhd^Qhh, Hh^Qhh, Hh^Qhh, Re, Hh^Qhh, Hh^Qhh, Rp^Vhcr, Re, Gs, Gs, Hh^Qhh, Hh^Qhh, Md^Qhh, Md^Qhh, Md^Qhh, Md^Qhh, Md^Qhh, Hh^Qhh, Hh^Qhh, Hh^Qhh
Hhd^Qhh, Hhd^Qhh, Re, Hhd^Qhh, Re, Re, Re, Hh^Qhh, Re, Re, Gs, Hh^Qhh, Hh^Qhh, Hh^Qhh, Md^Qhh, Md^Qhh, Md^Qhh, Md^Qhh, Hh^Qhh, Hh^Qhh, Hh^Qhh, Hh^Qhh
Re, Re, Gs, Re, Gs, Re, Gs, Re, Gs, Gs, Hh^Qhh, Hh^Qhh, Hh^Qhh, Md^Qhh, Md^Qhh, Md^Qhh, Hh^Qhh, Hh^Qhh, Hh^Qhh, Hh^Qhh, Rb, Rb
Gs, Gs, Gs^Fp, Gs, Gs^Fp, Gs, Re, Re, Gs, Hh^Qhh, Gs, Hhd^Qhh, Mm, Md^Qhh, Md^Qhh, Md^Qhh, Hh^Qhh, Hh^Qhh, Rb, Rb, Hh^Qhh, Hh^Qhh
Gg, Gs^Fp, Gs^Fp, Gs^Fp, Gs, Gs, Re, Gd^Vhr, Re, Gs, Gs, Hh^Qhh, Hh^Qhh, Md^Qhh, Md^Qhh, Hh^Qhh, Hh^Qhh, Rb, Hh^Qhh, Gs^Qhh, Mm^Qhh, Hh^Qhh
Gg, Gs^Fp, Gs^Fp, Gs, Re, Re, Gs, Re, Gs, Re, Gs, Hh^Qhh, Gs, Hh^Qhh, Hh^Qhh, Hh^Qhh, Rb, Rb, Hh^Qhh, Mm^Qhh, Md^Xm, Mm^Qhh
Gs^Fp, Gs^Fp, Gs^Fp, Gs, Re, Gs, Gs^Fp, Gs, Gs, Re, Re, Gs, Gs, Gs, Gs, Rb, Hh^Qhh, Hh^Qhh, Mm^Qhh, Md^Xm, Md^Xm, Md^Xm
Gg, Gg, Gs, Gs, Re, Gs, Gs^Fp, Gs^Fp, Gs^Fp, Gs, Gs, Re, Re, Re, Re, Rb, Gs, Hh^Qhh, Mm^Qhh, Md^Xm, Xu, Xu
Gs^Fp, Gg, Gs, Re, Gs, Gs, Gg, Gg, Hh^Qhh, Gg, Gs^Fp, Gs, Gs, Gs, Gs, Re, Gs^Fp, Hh^Qhh, Xu, Xu, Uu^Qhu, Uu^Qhu
Gs^Fp, Gs^Fp, Gs, Re, Gs, Gs^Fp, Hh^Qhh, Hh^Qhh, Mm^Qhh, Hh^Qhh, Hh^Qhh, Gs^Fp, Hh^Qhh, Gs^Fp, Gs^Fp, Re, Gg, Gs^Fp, Xu, Uu^Qhu, Uu^Qhu, Uu^Qhu
Gs^Fp, Gs^Fp, Gs, Re, Gs, Hh^Qhh, Mm^Qhh, Mm^Qhh, Mm^Qhh, Mm^Qhh, Mm^Qhh, Hh^Qhh, Mm^Qhh, Hh^Qhh, Hh^Qhh, Re, Ur^Qhu, Ur^Qhu, Ur^Qhu, Cud, Uu^Qhu, Uu^Qhu
Gs^Fp, Gs, Re, Re, Gs, Hh^Qhh, Mm^Qhh, Mm^Qhh, Mm^Qhh, Mm^Qhh, Mm^Qhh, Mm^Qhh, Mm^Qhh, Mm^Qhh, Hh^Qhh, Ur^Qhu, Ur^Qhu, Ur^Qhu, Ur^Qhu, Ur^Qhu, Uu^Qhu, Ur^Qhu
Gs^Fp, Gs, Re, Gs, Hh^Qhh, Hh^Qhh, Hh^Qhh, Mm^Qhh, Mm^Qhh, Md^Xm, Md^Xm, Md^Xm, Md^Xm, Mm^Qhh, Xu, Ur^Qhu, Ur^Qhu, Ur^Qhu, Ur^Qhu, Uu^Qhu, Uu^Qhu, Ur^Qhu
Gs^Fp, Gs, Re, Gs, Hh^Qhh, Hh^Qhh, Hh^Qhh, Mm^Qhh, Md^Xm, Md^Xm, Md^Xm, Md^Xm, Md^Xm, Md^Xm, Xu, Ur^Qhu, Ur^Qhu, Ur^Qhu, Ur^Qhu, Cud, Uu^Qhu, Uu^Qhu
Gs^Fp, Gs, Re, Gs, Gs^Fp, Hh^Qhh, Hh^Qhh, Mm^Qhh, Mm^Qhh, Mm^Qhh, Mm^Qhh, Mm^Qhh, Md^Xm, Md^Xm, Xu, Uu^Qhu, Uu^Qhu, Ur^Qhu, Ur^Qhu, Uu^Qhu, Uu^Vud, Uu^Qhu
Gs^Fp, Gs, Re, Gs, Gs^Fp, Hh^Qhh, Hh^Qhh, Mm^Qhh, Hh, Hh, Mm^Qhh, Mm^Qhh, Md^Xm, Xu, Cud, Uu^Qhu, Uu^Qhu, Cud, Uu^Qhu, Ur^Qhu, Uu^Qhu, Ur
Gs^Fp, Gs, Re, Gs, Gs, Hh^Qhh, Hh^Qhh, Mm^Qhh, Sm^Qhu, Sm^Qhu, Sm^Qhu, Mm^Qhh, Md^Xm, Xu, Uu^Qhu, Uu^Qhu, Uu^Qhu, Uu^Qhu, Uu^Vud, Ur^Qhu, Ur^Qhu, Uu^Qhu
Gg, Gs, Gs, Re, Re, Gs, Hh^Qhh, Hh^Qhh, Sm^Qhu, Wot^Qhu, Sm^Qhu, Hh^Qhh, Md^Xm, Xu, Xu, Uu^Qhu, Uu^Qhu, Uu^Qhu, Uu^Qhu, Ur^Qhu, Uu^Qhu, Uu^Qhu
Gs^Fp, Gg^Ve, Gs, Gs, Re, Gs, Sm^Qhu, Sm^Qhu, Ww^Qhu, Wot^Qhu, Sm^Qhu, Hh^Qhh, Mm^Qhh, Md^Xm, Md^Xm, Xu, Xu, Xu, Ur^Qhu, Ur^Qhu, Ur^Qhu, Uu^Qhu
Gg, Gs^Fp, Gs, Re, Sm^Qhu, Sm^Qhu, Ww^Qhu, Wot^Qhu, Ww^Qhu, Sm^Qhu, Hh^Qhh, Hh^Qhh, Mm^Qhh, Mm^Qhh, Mm^Qhh, Md^Xm, Md^Xm, Hh^Qhh, Re, Xu, Xu, Ur^Qhu
Gs^Fp, Gs^Fp, Gs, Re, Sm^Qhu, Ww^Qhu, Ww^Qhu, Ww^Qhu, Sm^Qhu, Sm^Qhu, Gg^Ve, Hh^Qhh, Hh^Qhh, Mm^Qhh, Mm^Qhh, Mm^Qhh, Mm^Qhh, Hh^Qhh, Re, Hh^Qhh, Md^Xm, Xu
Sm^Qhu, Sm^Qhu, Sm^Qhu, Re, Ww^Bw\, Wwrt^Qhu, Sm^Qhu, Sm^Qhu, Gll^Fmf, Gll^Fmf, Hh^Qhh, Hh^Qhh, Gll^Fmf, Hh^Qhh, Hh^Qhh, Mm^Qhh, Hh^Qhh, Hh^Qhh, Re, Hh^Qhh, Mm^Qhh, Md^Xm
Ww^Qhu, Ww^Qhu, Ww^Qhu, Ww^Qhu, Ww^Qhu, Ss^Bw\, Ss^Bw\, Ss^Qhu, Re, Gll^Fmf, Gll^Fmf, Gll^Fmf, Gll^Fmf, Cvr, Hh^Qhh, Gg^Ve, Re, Re, Hh^Qhh, Hh^Qhh, Mm^Qhh, Md^Xm
Ww^Qhu, Ww^Qhu, Sm^Qhu, Ww^Qhu, Ww^Qhu, Sm^Qhu, Sm^Qhu, Re, Ww^Qhu, Re, Re, Gll^Fmf, Gll^Fmf, Cvr, Re, Re, Hh^Qhh, Hh^Qhh, Mm^Qhh, Mm^Qhh, Md^Xm, Md^Xm
Sm^Qhu, Sm^Qhu, Gs^Fds, Sm^Qhu, Sm^Qhu, Ww^Qhu, Ww^Qhu, Sm^Qhu, Ww^Qhu, Cvr, Cvr, Re, 1 Kvr, Cvr, Cvr, Hh^Qhh, Hh^Qhh, Mm^Qhh, Mm^Qhh, Mm, Md^Xm, Md^Xm
Gs^Fds, Gs^Fds, Gg^Ve, Gs^Fds, Sm^Qhu, Ww^Qhu, Ww^Qhu, Sm^Qhu, Sm^Qhu, Gs^Fp, Gll^Fmf, Cvr, Gll^Fmf, Re, Gll^Fmf, Cvr, Gll^Fmf, Hh^Qhh, Hh^Qhh, Mm^Qhh, Mm^Qhh, Md^Xm
Gs^Fds, Gs^Fds, Gs^Fds, Gs^Fds, Sm^Qhu, Ww^Qhu, Ww^Qhu, Ww^Qhu, Sm^Qhu, Gs^Fp, Gs^Fp, Cvr, Gll^Fmf, Re, Re, Gll^Fmf, Gll^Fmf, Gll^Fmf, Gll^Fmf, Hh^Qhh, Hh^Qhh, Gll^Fmf
Gs^Fds, Gs^Fds, Gs^Fds, Gs^Fds, Sm^Qhu, Ww^Qhu, Ww^Qhu, Ww^Qhu, Sm^Qhu, Ss^Qhu, Sm^Qhu, Cvr, Gll^Fmf, Gll^Fmf, Re, Gll^Fmf, Re, Gll^Fmf, Gll^Fmf, Gg^Ve, Gll^Fmf, Hh^Qhh
Gs^Fds, Gs^Fds, Gs^Fds, Gs^Fds, Gs^Fds, Sm^Qhu, Ww^Qhu, Ww^Qhu, Ww^Qhu, Sm^Qhu, Ww^Qhu, Sm^Qhu, Sm^Qhu, Gg^Ve, Gll^Fmf, Re, Gll^Fmf, Re, Re, Gll^Fmf, Gll^Fmf, Gll^Fmf
Gs^Fds, Gs^Fds, Gs^Fds, Gs^Fds, Gs^Fds, Sm^Qhu, Sm^Qhu, Ww^Qhu, Ww^Qhu, Ww^Qhu, Ww^Qhu, Ww^Qhu, Ww^Qhu, Sm^Qhu, Sm^Qhu, Gll^Fmf, Gll^Fmf, Gll^Fmf, Re, Gll^Fmf, Gll^Fmf, Gll^Fmf
Gg, Gs^Fds, Gg, Gs^Fds, Gg, Gs^Fp, Gs^Fp, Sm^Qhu, Gg, Ww^Qhu, Ww^Qhu, Ww^Qhu, Ww^Qhu, Ww^Qhu, Ww^Qhu, Sm^Qhu, Gg, Gll^Fmf, Gg, Re, Re, Gll^Fmf
