Gs^Ftp, Gs^Ftp, Gs^Ftp, Hd, Hd, Gs^Ftp, Wwrg, Gs^Ftp, Re, Gs^Fp, Gd^Fts, Gs^Ftp, Ww, Gs^Ftp, Dd^Ftd, Dd^Ftd, Dd, Re, Gd^Fts, Gd^Fts, Gd^Fts, Mm
Gs^Ftp, Wwrg, Gs^Ftp, Hd, Hd, Gs^Ftp, Wwrg, Gs^Ftp, Re, Gd^Fts, Gd^Fts, Gs^Ftp, Ww, Gs^Ftp, Ds, Gd^Vo, Dd, Re, Gd^Fts, Gd^Fts, Gd^Fts, Gd^Fts
Hd, Gs^Ftp, Hd, Mdd, Hd, Gs^Ftp, Gd^Vo, Gs^Ftp, Gs^Ftp, Re, Gd^Fts, Gs^Ftp, Ww, Gs^Ftp, Gs^Ftp, Dd, Cd, Re, Cd, Gd^Fts, Gd^Fts, Gd^Fts
Hd, Hd, Mdd, Mdd, Hd, Hd, Gs^Ftp, Wwrg, Gs^Ftp, Re, Gd^Fts, Gs^Ftp, Gs^Ftp, Ww, Gs^Ftp, Cd, Dd^Do, Cd, Dd^Do, Cd, Gd^Fts, Gd^Fts
Gd^Fts, Mdd, Mdd, Mdd, Hd, Hd, Gd^Fts, Gd^Fts, Gd^Fts, Re, Gd^Fts, Gd^Fts, Gs^Ftp, Ww, Gs^Ftp, Cd, Cd, 3 Kd, Cd, Cd, Gd^Fts, Gd^Fts
Mdd, Mdd, Mdd^Xm, Mdd, Mdd, Mdd, Gd^Fts, Gd^Fts, Gd^Fts, Re, Gd^Fts, Gs^Ftp, Ww, Ww, Gs^Ftp, Ds, Re, Cd, Dd, Gd^Vo, Gd^Fts, Gd^Fts
Mdd^Xm, Mdd^Xm, Mdd^Xm, Mdd, Hd, Hd, Hd, Gd^Fts, Gd^Fts, Re, Gd^Fts, Gs^Ftp, Ww, Gs^Ftp, Re, Re, Gd^Fts, Dd, Gd^Fts, Gd^Fts, Gd^Fts, Gd^Fts
Mdd^Xm, Mdd, Hd, Dd^Vdt, Hd, Hd, Hd, Hd, Hd, Re, Re, Gs^Ftp, Ww^Bw/, Re, Gs^Ftp, Re, Re, Gd^Fts, Gd^Fts, Gd^Fts, Re, Re
Mdd^Xm, Mdd, Hd, Hd, Hd, Hd, Mdd, Mdd, Mdd, Dd^Ftd, Dd, Re, Gd^Vo, Ww, Gs^Ftp, Gd^Fts, Gd^Fts, Re, Re, Re, Gd^Fts, Gd^Fts
Mdd, Hd, Hd, Hd, Hd, Hd, Mdd, Mdd, Dd^Ftd, Dd^Ftd, Ds, Re, Gs^Ftp, Ww, Ww, Gs^Ftp, Gd^Fts, Gd^Fts, Re, Gd^Fts, Gd^Fts, Gd^Fts
Gd^Fts, Gd^Fts, Gd^Fts, Hd, Hd, Mdd, Mdd, Mdd, Hd, Ds, Ds, Re, Ds, Gs^Ftp, Ww, Gs^Ftp, Gs^Ftp, Gd^Fts, Re, Gd^Fts, Gd^Fts, Gd^Fts
Gd^Fts, Gd^Fts, Gd^Fts, Hd, Mdd, Mdd, Mdd, Dd^Vdt, Hd, Hd, Ds, Re, Ds, Gs^Ftp, Gs^Ftp, Ww, Gs^Ftp, Gd^Fts, Re, Gd^Fts, Gd^Fts, Gd^Fts
Gd^Fts, Gd^Fts, Hd, Hd, Hd, Mdd, Mdd, Hd, Hd, Hd, Hd, Re, Ds, Gs^Ftp, Ww, Ww, Gs^Ftp, Gd^Fts, Re, Gd^Fts, Gd^Fts, Gd^Fts
Hd, Dd^Vdt, Hd, Hd, Hd, Hd, Mdd, Mdd, Hd, Hd, Hd, Re, Ds, Dd^Vdt, Ww, Gs^Ftp, Gd^Fts, Gd^Fts, Re, Gd^Fts, Gd^Fts, Gs^Ftp
Mdd, Mdd, Mdd, Hd, Dd^Ftd, Hd, Mdd, Mdd, Mdd, Mdd, Hd, Re, Ds, Gs^Ftp, Ww, Gs^Ftp, Re, Re, Gd^Fts, Gd^Fts, Gs^Ftp, Gs^Ftp
Mdd^Xm, Mdd^Xm, Hd, Hd, Dd^Ftd, Mdd, Mdd, Mdd, Hd, Hd, Re, Re, Re, Gs^Ftp, Ww^Bw/, Re, Gd^Fts, Re, Re, Gd^Fts, Gs^Ftp, Wwrg
Mdd^Xm, Mdd, Mdd, Hd, Dd, Mdd, Mdd, Hd, Hd, Re, Gs^Ftp, Gs^Ftp, Re, Re, Ww, Gs^Ftp, Gs^Ftp, Gd^Fts, Re, Gs^Ftp, Wwrg, Wwrg
Mdd^Xm, Mdd, Mdd, Hd, Hd, Mdd, Hd, Hd, Re, Re, Gs^Ftp, Wwrg, Wwrg, Gs^Ftp, Gs^Ftp, Ww, Gs^Ftp, Gd^Fts, Re, Gs^Ftp, Gs^Ftp, Wwrg
Mdd, Mdd, Dd^Vdt, Hd, Hd, Hd, Dd^Vdr, Re, Gs^Ftp, Gs^Ftp, Wwrg, Wwrg, Gs^Ftp, Gs^Ftp, Dd^Vdr, Ww, Ww, Gs^Ftp, Gd^Fts, Re, Gs^Ftp, Gd^Fts
Mdd, Hd, Cdr, Dd, Dd, Dd, Re, Re, Gs^Ftp, Wwrg, Wwrg, Wwrg, Gs^Ftp, Gd^Fts, Gd^Fts, Gs^Ftp, Ww, Gs^Ftp, Gd^Fts, Re, Gs^Ftp, Gd^Fts
Hd, Cdr, 2 Kdr, Cdr, Dd, Re, Hd, Re, Re, Wwrg, Wwrg, Gs^Ftp, Gd^Fts, Gd^Fts, Gd^Fts, Gs^Ftp, Ww, Gs^Ftp, Wwrg, Re, Gs^Ftp, Gd^Fts
Hd, Cdr, Cdr, Cdr, Re, Re, Cdr, Hd, Dd^Vdr, Re, Re, Gs^Ftp, Gd^Fts, Gd^Fts, Gd^Vo, Gs^Ftp, Ww, Gs^Ftp, Wwrg, Re, Gs^Ftp, Gd^Fts
Wwrg, Dd, Dd, Re, Dd, Cdr, 1 Kdr, Cdr, Hd, Hd, Gs^Ftp, Re, Re, Gd^Fts, Gd^Fts, Gs^Ftp, Ww^Bw/, Re, Re, Re, Gs^Ftp, Gd^Fts
Dd, Dd, Re, Re, Hd, Cdr, Cdr, Cdr, Hd, Hd, Gs^Ftp, Wwrg, Gs^Ftp, Re, Re, Re, Gs^Ftp, Ww, Ww, Re, Gd^Vo, Gs^Ftp
Re, Re, Hd, Hd, Dd^Vdr, Hd, Hd, Hd, Gs^Ftp, Gs^Ftp, Wwrg, Wwrg, Gs^Ftp, Gd^Fts, Gd^Fts, Gd^Fts, Gd^Fts, Gs^Ftp, Gs^Ftp, Ww, Ww, Gs^Ftp
Hd, Hd, Hd, Hd, Hd, Hd, Hd, Gs^Ftp, Wwrg, Wwrg, Wwrg, Wwrg, Gs^Ftp, Gd^Fts, Gd^Fts, Gd^Fts, Gd^Fts, Gd^Fts, Gd^Fts, Gs^Ftp, Ww, Gs^Ftp
