Gll^Fdw, Gll^Fdw, Gg, Gll^Fdw, Gll^Fdw, Gll^Fdw, Gd, Gd, Gd, Gd, Gll^Fdw, Gs^Fp, Re, Gs, Gd^Fts, Gg, Gd^Fts, Gg, Ww, Sm, Sm, Gg, Sm, Ss, Ss, Ss, Ss, Ss, Ss, Gg, Ss, Gg
Gll^Fdw, Gll^Fdw, Gll^Fdw, Gll^Fdw, Gd, Gll^Fdw, Gll^Fdw, Gg^Vc, Gll^Fdw, Gll^Fdw, Gs, Gs, Re, Gs, Gd^Fts, Gd^Fts, Gd^Fts, Sm, Ww, Ww, Ww, Ww, Sm, Ss, Ss, Ss, Ss, Ss, Ss, Ss, Ss, Ss
Gll^Fdw, Gll^Fdw, Ce, Gll^Fdw, Gd, Gd, Gd, Gd, Ce, Gs, Gs, Gs, Re, Gs, Gd^Fts, Gd^Fts, Gd^Fts, Sm, Sm, Ww, Ww, Ww, Sm, Ss, Ss, Ce, Ce, Ss, 4 Ke, Ss, Re, Re
Gll^Fdw, Gll^Fdw, Gll^Fdw, Ce, Ce, 3 Ke, Ce, Ce, Gll^Fdw, Gs, Gs, Gs, Re, Gs, Gd^Fts, Gd^Fts, Gd^Fts, Gd^Fts, Sm, Ww, Ww, Ww, Ww, Sm, Ss, Gg, Gg, Ce, Re, Ce, Ce, Gs
Gll^Fdw, Gll^Fdw, Gg^Vc, Gll^Fdw, Gll^Fdw, Gll^Fdw, Gll^Fdw, Gs, Gs, Gs, Re, Re, Gs, Gs, Gd^Fts, Gd^Fts, Gd^Fts, Gd^Fts, Gd^Fts, Sm, Sm, Ww, Ww, Sm, Ss, Gg^Vc, Re, Re, Gs, Gs, Ce, Gs
Gs, Gll^Fdw, Gll^Fdw, Gll^Fdw, Gll^Fdw, Gll^Fdw, Gll^Fdw, Gll^Fdw, Gs, Gs, Re, Gs, Gd^Fts, Gd^Fts, Gd^Fts, Gd^Fts, Gd^Fts, Gd^Fts, Gd^Fts, Sm, Ww, Ww, Ww, Sm, Re, Re, Gs, Gs, Gg^Vc, Gs, Gs, Gs
Re, Gs, Gs, Gs, Gs, Gll^Fdw, Gll^Fdw, Gll^Fdw, Gs, Re, Gs, Gs, Gd^Fts, Gd^Fts, Gd^Fts, Gd^Fts, Gd^Fts, Gd^Fts, Gd^Fts, Sm, Sm, Ww, Ww^Bw/, Re, Sm, Gs, Gs^Fp, Gs^Fp, Gs, Gs^Fp, Gs, Gs
Gs, Re, Re, Re, Re, Gs, Gs, Gll^Fdw, Gs, Re, Gs, Gd^Fts, Gd^Fts, Gd^Fts, Gg^Vc, Gd^Fts, Gd^Fts, Gd^Fts, Gs, Gs, Re, Ww^Bw/, Ww, Ww, Sm, Gs^Fp, Sm, Sm, Sm, Sm, Sm, Gs
Hh, Gs, Gs, Gs, Gs, Re, Re, Gs, Gs, Re, Gs, Gd^Fts, Gd^Fts, Gd^Fts, Gd^Fts, Gd^Fts, Gs, Gs, Re, Re, Sm, Sm, Ww, Ww, Ww, Sm, Ss, Ss, Ss, Ss, Ss, Sm
Hh, Gs^Fp, Gll^Fmf, Gll^Fmf, Gs^Fp, Gs, Gs, Re, Re, Re, Re, Gd^Fts, Gd^Fts, Gd^Fts, Gs, Gs, Re, Re, Sm, Sm, Ww^Ewl, Sm, Ww, Ww, Ww, Sm, Sm, Ss, Sm, Ss, Sm, Sm
Hh, Gll^Fmf, Gll^Fmf, Gll^Fmf, Gll^Fmf, Gs^Fp, Gs, Gs, Gs, Re, Re, Gs, Gs, Gs, Re, Re, Sm, Sm, Ww^Ewl, Ww^Ewl, Ww^Ewl, Sm, Sm, Ww, Ww, Ww, Ww, Sm, Gg^Vc, Sm, Gll^Fdf, Gg
Gll^Fmf, Gs^Fp, Gll^Fmf, Gg^Vc, Gll^Fmf, Gs^Fp, Gs^Fp, Gs^Fp, Gs^Fp, Gs, Gs, Re, Re, Re, Gs, Re, Sm, Ww^Ewl, Ww^Ewl, Ww^Ewl, Ww^Ewl, Sm, Sm, Ww, Ww, Ww, Ww, Sm, Sm, Gll^Fdf, Gll^Fdf, Gg
Gll^Fmf, Gs^Fp, Gs^Fp, Gll^Fmf, Gll^Fmf, Gs^Fp, Gll^Fmf, Gs^Fp, Gll^Fmf, Gs^Fp, Gs, Gs, Re, Gs, Gs, Re, Sm, Ww^Ewl, Ww^Ewl, Ww^Ewl, Ss, Ww^Ewf, Ss, Sm, Ww, Ww, Ww, Ww, Sm, Sm, Gll^Fdf, Gs^Fp
Gll^Fmf, Gll^Fmf, Gll^Fmf, Gll^Fmf, Gll^Fmf, Gll^Fmf, Gll^Fmf, Gll^Fmf, Gs^Fp, Gll^Fmf, Gs, Re, Re, Gs^Fp, Gs, Re, Sm, Ww^Ewl, Ww^Ewl, Ww^Ewl, Ss, Ss, Ss, Sm, Sm, Ww, Ww, Ww, Ww, Sm, Gg^Ve, Gs^Fp
Gs^Fp, Gll^Fmf, Gs^Fp, Gs^Fp, Gll^Fmf, Gs^Fp, Gll^Fmf, Gs^Fp, Gs^Fp, Gll^Fmf, Gs, Re, Gs, Gs^Fp, Gs, Re, Re, Sm, Ss, Ss, Ss, Ss, Ss, Ss, Ss, Sm, Ww, Ww, Ww, Sm, Gll^Kov, Gs^Fp
Gs^Fp, Gll^Fmf, Gll^Fmf, Gs^Fp, Gs^Fp, Gll^Fmf, Gs^Fp, Gll^Fmf, Gll^Fmf, Gs, Re, Re, Gs, Gs^Fds, Gs^Fds, Gs, Re, Sm, Sm, Ww^Ewf, Ww^Ewf, Ss, Ss, Ss, Ss, Sm, Ww, Ww, Sm, Gll^Kov, Gll^Kov, Gg^Kov
Gll^Fmf, Gll^Fmf, Gll^Fmf, Gs^Fp, Gll^Fmf, Gs^Fp, Gll^Fmf, Gll^Fmf, Gs, Gs, Re, Gs, Gs^Fp, Gs^Fds, Gs^Fds, Gs, Gs, Re, Sm, Ww^Ewf, Ww^Ewf, Ww^Ewf, Ss, Ss, Ss, Sm, Ww, Ww, Sm, Gg^Kov, Gll^Kov, Gg^Kov
Gll^Fmf, Gll^Fmf, Gll^Fmf, Gll^Fmf, Gll^Fmf, Gs^Fp, Gll^Fmf, Gll^Fmf, Gs, Re, Gs, Gs^Fds, Gs^Fp, Gs^Fp, Gs^Fds, Gs^Fds, Gs, Re, Re, Sm, Sm, Ss, Ww^Ewf, Ss, Ww^Ewf, Sm, Sm, Ww, Sm, Gg^Fet, 2 Re^Kov, Re^Kov
Gll^Fmf, Gll^Fmf, Gll^Fmf, Gll^Fmf, Gll^Fmf, Gll^Fmf, Gll^Fmf, Gs^Fp, Gs, Re, Gs, Gs^Fds, Gs^Fds, Gs^Fds, Gs^Fds, Gs^Fp, Gs^Fds, Gs, Gs, Re, Re, Sm, Ww^Ewf, Ss, Ss, Ww^Ewf, Sm, Ww, Ww^Bw/, Ww^Bw/, Gg^Fet, Gs^Fp
Gll^Fmf, Gll^Fmf, Gll^Fmf, Gll^Fmf, Gll^Fmf, Gll^Fmf, Gll^Fmf, Gll^Fmf, Gs, Re, Gs, Gs^Fds, Gs^Fp, Gs^Fds, Gs^Fds, Gs^Fp, Gs^Fds, Gs^Fds, Gs, Re, Re, Sm, Sm, Ss, Sm, Cvr, Re, Ww^Bw/, Ww, Sm, Sm, Sm
Gll^Fmf, Gll^Fmf, Gll^Fmf, Gll^Fmf, Gg^Vc, Gll^Fmf, Gll^Fmf, Gll^Fmf, Gs, Re, Gs, Gs^Fds, Gg^Vc, Gs^Fds, Gs^Fds, Gs^Fds, Gs^Fds, Gs^Fp, Gs^Fp, Gs, Gs, Re, Re, Sm, Re, Re, Cvr, Sm, Ww, Ww, Ww, Sm
Gll^Fmf, Gll^Fmf, Gll^Fmf, Gll^Fmf, Gll^Fmf, Gll^Fmf, Gll^Fmf, Gll^Fmf, Gs, Re, Gs, Gs^Fds, Gs^Fds, Gs^Fds, Gs^Fds, Gs^Fp, Gs^Fds, Gs^Fds, Gs^Fp, Gs^Fp, Gs^Fds, Gs, Re, Re, Gs, Gs, Ss, Sm, Ww, Ww, Ww, Ww
Gll^Fmf, Gll^Fmf, Gll^Fmf, Gll^Fmf, Gll^Fmf, Gll^Fmf, Gll^Fmf, Gll^Fmf, Gs, Re, Gs, Gs^Fp, Gs^Fds, Gs^Fds, Gs^Fds, Gs^Fds, Gs^Fp, Gs^Fds, Gs^Fds, Gs^Fds, Gs, Re, Gs, Gs, Gs^Fms, Gs^Fp, Ss, Sm, Sm, Ww, Ww, Ww
Gll^Fmf, Gll^Fmf, Gll^Fmf, Gll^Fmf, Gll^Fmf, Gll^Fmf, Gll^Fmf, Gll^Fmf, Gs, Re, Re, Gs, Gs^Fp, Gs^Fp, Gs^Fds, Gs^Fp, Gs, Gs^Fds, Gs, Gs, Re, Re, Gs, Gs^Fms, Gs^Fms, Gs^Fms, Gs^Fms, Ss, Ss, Sm, Ww, Ww
Gs, Gll^Fmf, Gs, Gll^Fmf, Gll^Fmf, Gll^Fmf, Gll^Fmf, Gll^Fmf, Gll^Fmf, Gs, Re, Gs, Gs^Fds, Gs^Fds, Gs^Fds, Gs^Fp, Gs, Gs, Re, Re, Gs, Gs, Gs^Fms, Gs^Fms, Gs^Fms, Gs^Fms, Gs^Fms, Gs^Fms, Ss, Sm, Ww, Ww
Gs, Gs, Gs, Gs, Gs, Gll^Fmf, Gll^Fmf, Gll^Fmf, Gll^Fmf, Gs, Re, Gs, Gs, Gs^Fds, Gs^Fp, Gs^Fds, Gs, Re, Gs, Gs, Gs^Fms, Gs^Fms, Gs^Fms, Gs^Fms, Gs^Fms, Gs^Fms, Gs^Fms, Gs^Fms, Ss, Sm, Sm, Ww
Mm, Gs, Mm, Gs, Gs, Gs, Gs, Gg, Gg, Gg^Vc, Re, Re, Re, Gs, Gs, Gs, Re, Re, Hh, Gs^Fp, Gs^Fms, Gs^Fp, Gs^Fms, Gs^Fms, Gs^Fms, Gs^Fms, Gs^Fms, Gs^Fms, Gs^Fms, Ss, Ss, Sm
Mm, Mm, Gg^Vc, Mm, Mm, Gs, Ce, Ce, Ce, Re, Ce, Ce, Ce, Re, Re, Re, Gs, Gs, Gs^Fp, Hh, Gs^Fms, Gs^Fms, Gg^Vc, Gs^Fms, Gs^Fms, Gs^Fms, Gs^Fms, Gs^Fms, Gs^Fms, Gs^Fms, Gs^Fms, Ss
Gg, Mm, Hh, Mm, Mm, Mm, Mm, Mm, Hh, 1 Ke, Rb, Gg, Rb, Re, Gs, Gs, Hh, Gg, Gg, Gg, Gs^Fms, Gs^Fms, Gs^Fms, Gs^Fms, Gs^Fms, Gs^Fms, Gs^Fms, Gs^Fms, Gs^Fms, Gs^Fms, Gs^Fms, Gs^Fms
Gg, Hh, Mm, Mm, Hh, Hh, Hh, Hh, Rb, Rb, Hh, Rb, Hh, Hh, Hh, Gs^Fp, Gg^Vc, Gg, Gs^Fp, Gs^Fp, Gs^Fms, Gs^Fms, Gs^Fms, Gs^Fms, Gs^Fms, Gs^Fms, Gs^Fms, Gs^Fms, Gs^Fms, Gs^Fms, Gs^Fms, Gs^Fms
Gg, Hh, Hh, Hh, Rb, Rb, Rb, Rb, Hh, Hh, Mm, Hh, Hh, Hh, Hh, Hh, Gs^Fp, Gs^Fp, Hh, Gg, Gs^Fp, Gs^Fms, Gs^Fms, Gs^Fms, Gs^Fms, Gs^Fms, Gs^Fms, Gs^Fms, Gs^Fms, Gs^Fms, Gg^Vc, Gg
Gg, Mm, Mm, Hh, Rb, Rb, Hh, Hh, Gg, Mm, Mm, Mm, Mm, Mm, Mm, Hh, Gs^Fp, Hh, Gg, Gg, Gs^Fp, Gs^Fms, Gs^Fms, Gs^Fms, Gs^Fms, Gs^Fms, Gs^Fms, Gs^Fms, Gs^Fms, Gs^Fms, Gs^Fms, Gs^Fms
