Gs^Ftp, Re, Gs^Ftp, Re, Re, Re, Re, Re, Gs^Ftp, Gg, Rb, Re, Gs^Ftp, Re, Gs^Ftp, Re, Re
Gs^Ftp, Re, Gs^Ftp, Gs^Ftp, Gs^Ftp, Gs^Ftp, Gs^Ftp, Gs^Ftp, Gs^Ftp, Gs^Ftp, Rb, Gs^Ftp, Re, Gs^Ftp, Gs^Ftp, Gs^Ftp, Gs^Ftp
Gs^Ftp, Re, Gs^Ftp, Gs^Ftp, Gs^Ftp, Gs^Ftp, Re, Gs^Ftp, Gs^Ftp, Rb, Gs^Ftp, Gs^Ftp, Gs^Ftp, Gs^Ftp, Gs^Ftp, Gs^Ftp, Gs^Ftp
Gs^Ftp, Gs^Ftp, Gs^Ftp, Gs^Ftp, Re, Gs^Ftp, Gs^Ftp, Gs^Ftp, Rb, Rb, Gs^Ftp, Gs^Ftp, Gs^Ftp, Re, Gs^Ftp, Re, Gs^Ftp
Gs^Ftp, Gs^Ftp, Gs^Ftp, Gs^Ftp, Gs^Ftp, Gs^Ftp, Gs^Ftp, Gs^Ftp, Re, Gs^Ftp, Gs^Ftp, Gs^Ftp, Gs^Ftp, Gs^Ftp, Gs^Ftp, Gs^Ftp, Gs^Ftp
Re, Gs^Ftp, Gs^Ftp, Gs^Ftp, Gd^Fts, Gs^Ftp, Gd^Fts, Re, Re, Re, Gd^Fts, Gs^Ftp, Gs^Ftp, Gs^Ftp, Gs^Ftp, Gs^Ftp, Re
Gs^Ftp, Gs^Ftp, Gs^Ftp, Gs^Ftp, Re^Vct, Gd^Fts, Re, Re, Re, Re, Re^Vct, Re^Vct, Re^Vct, Re, Re, Gs^Ftp, Gs^Ftp
Gs^Ftp, Gs^Ftp, Re^Vct, Re^Vct, Re, Re^Vct, Re, Re, Re, Re, Re^Vct, Re, Re, Re^Vct, Gd^Fts, Gs^Ftp, Gs^Ftp
Gs^Ftp, Gs^Ftp, Re^Vct, Re, Re^Vct, Re^Vct, Re, Re, Re, Re, Re, Re^Vct, Re^Vct, Re^Vct, Gd^Fts, Gs^Ftp, Gs^Ftp
Gs^Ftp, Gs^Ftp, Gd^Fts, Re^Vct, Re, Re, Re, Re, Re, 1 Cer, Re, Re, Re, Gd^Fts, Gs^Ftp, Gs^Ftp, Gs^Ftp
Gs^Ftp, Gs^Ftp, Gs^Ftp, Re, Re, Re, Re, 2 Cer, Re, Re, Re^Vct, Re^Vct, Re^Vct, Re, Re, Gs^Ftp, Gs^Ftp
Gs^Ftp, Gs^Ftp, Re, Re, Re, Re, Re, Re, Re, Re, Re^Vct, Re, Re^Vct, Re, Gs^Ftp, Gs^Ftp, Gs^Ftp
Gs^Ftp, Gs^Ftp, Gs^Ftp, Re, Gs^Ftp, Gd^Fts, Gd^Fts, Re, Re, Re, Gd^Fts, Re^Vct, Gd^Fts, Re, Gs^Ftp, Gs^Ftp, Gs^Ftp
Gs^Ftp, Gs^Ftp, Gs^Ftp, Gs^Ftp, Gs^Ftp, Gd^Fts, Gs^Ftp, Rb, Gs^Ftp, Re, Gs^Ftp, Gd^Fts, Gs^Ftp, Re, Gs^Ftp, Gs^Ftp, Gs^Ftp
Gs^Ftp, Gs^Ftp, Gs^Ftp, Gs^Ftp, Gs^Ftp, Gs^Ftp, Gs^Ftp, Rb, Gs^Ftp, Gs^Ftp, Re, Gs^Ftp, Re, Gs^Ftp, Gs^Ftp, Gs^Ftp, Gs^Ftp
Gs^Ftp, Gs^Ftp, Gs^Ftp, Re, Gs^Ftp, Gs^Ftp, Gs^Ftp, Rb, Gs^Ftp, Gs^Ftp, Gs^Ftp, Re, Gs^Ftp, Re, Gs^Ftp, Gs^Ftp, Re
Gs^Ftp, Gs^Ftp, Gs^Ftp, Gs^Ftp, Gs^Ftp, Gs^Ftp, Gs^Ftp, Rb, Re, Gs^Ftp, Gs^Ftp, Gs^Ftp, Gs^Ftp, Gs^Ftp, Gs^Ftp, Gs^Ftp, Gs^Ftp
