Mdd^Xm, Mdd^Xm, Mdd^Xm, Mdd^Xm, Mdd^Xm, Mdd^Xm, Mdd^Xm, Mdd^Xm, Mdd^Xm, Mdd^Xm, Mdd^Qhh, Mm^Xm, Mdd^Qhh, Mm, Hhd^Qhh, Mm, Rb
Mdd^Xm, Mdd^Xm, Mdd^Xm, Mdd^Xm, Mdd^Xm, Mdd^Xm, Mdd^Xm, Mdd^Xm, Mdd^Xm, Mdd^Qhh, Mdd^Qhh, Mdd^Qhh, Mdd^Qhh, Hhd^Qhh, Rb, Rb, Hhd
Mdd^Xm, Mdd^Xm, Mdd^Xm, Mdd^Xm, Mdd^Xm, Mdd^Xm, Mdd^Xm, Mdd^Xm, Mdd^Xm, Mdd^Qhh, Mdd^Qhh, Mdd^Qhh, Mdd^Qhh, Hhd^Qhh, Rb, Hhd, Hhd
Mdd^Xm, Mdd^Xm, Mdd^Xm, Mdd^Xm, Mdd^Xm, Mdd^Xm, Mdd^Xm, Mdd^Xm, Mdd^Qhh, Mdd^Qhh, Mdd^Qhh, Mdd^Qhh, Mdd^Qhh, Hhd^Qhh, Rb, Hhd, Hhd
Mdd^Xm, Mdd^Xm, Mdd^Xm, Mdd^Xm, Mdd^Xm, Mdd^Xm, Mdd^Xm, Mdd^Xm, Mdd^Qhh, Mdd^Qhh, Mdd^Qhh, Mdd^Qhh, Mdd^Qhh, Hhd^Qhh, Rb, Hhd, Hhd
Mdd^Xm, Mdd^Xm, Mdd^Xm, Mdd^Xm, Mdd^Xm, Mdd^Xm, Mdd^Qhh, Mdd^Qhh, Mdd^Qhh, Mdd^Qhh, Mdd^Qhh, Mdd^Qhh, Mdd^Qhh, Hhd^Qhh, Rb, Re^Vct, Gd^Fts
Mdd^Xm, Mdd^Xm, Mdd^Xm, Mdd^Xm, Mdd^Qhh, Mdd^Qhh, Mdd^Qhh, Mdd^Qhh, Mdd^Qhh, Mdd^Qhh, Mdd^Qhh, Mdd^Qhh, Hhd^Qhh, Hhd^Qhh, Rb, Gd^Fts, Gd^Fts
Mdd^Xm, Mdd^Xm, Mdd^Qhh, Mdd^Qhh, Mdd^Qhh, Mdd^Qhh, Mdd^Qhh, Mdd^Qhh, Mdd^Qhh, Mdd^Qhh, Mdd^Qhh, Mdd^Qhh, Hhd^Qhh, Rb, 3 Ke, Ce, Gd^Fts
Mdd^Qhh, Mdd^Qhh, Mdd^Qhh, Mdd^Qhh, Mdd^Qhh, Mdd^Qhh, Mdd^Qhh, Mdd^Qhh, Mdd^Qhh, Mdd^Qhh, Hhd^Qhh, Hhd^Qhh, Rb, Rb, Ce, Ce, Gd^Fts
Mdd^Qhh, Mdd^Qhh, Mdd^Qhh, Mdd^Qhh, Mdd^Qhh, Mdd^Qhh, Mdd^Qhh, Mdd^Qhh, Hhd^Qhh, Hhd^Qhh, Rb, Rb, Gd^Fts, Ce, Gd^Fts, Gd^Fts, Gd^Fts
Mdd^Qhh, Mdd^Qhh, Mdd^Qhh, Mdd^Qhh, Mdd^Qhh, Mdd^Qhh, Hhd^Qhh, Hhd^Qhh, Hhd^Qhh, Hhd^Qhh, Rb, Gd^Fts, Gd^Fts, Gd^Fts, Gd^Fts, Re^Vct, Gd^Fts
Mdd^Qhh, Mdd^Qhh, Mdd^Qhh, Mdd^Qhh, Mdd^Qhh, Mdd^Qhh, Hhd^Qhh, Hhd^Qhh, Hhd^Qhh, Hhd^Qhh, Rb, Gd^Fts, Gd^Fts, Gd^Fts, Gd^Fts, Gd^Fts, Gd^Fts
Mdd^Qhh, Mdd^Qhh, Mdd^Qhh, Mdd^Qhh, Hhd^Qhh, Hhd^Qhh, Hhd^Qhh, Hhd^Qhh, Gs^Qhuf, Rb, Gd^Fts, Gd^Fts, Gd^Fts, Gd^Fts, Gd^Fts, Gd^Fts, Gd^Fts
Mdd^Qhh, Mdd^Qhh, Hhd^Qhh, Hhd^Qhh, Hhd^Qhh, Hhd^Qhh, Gs^Qhuf, Gs^Qhuf, Gs^Qhuf, Rb, Rb, Gd^Fts, Gd^Fts, Gd^Fts, Gd^Fts, Gd^Fts, Gs^Qhuf
Hhd^Qhh, Mdd^Qhh, Hhd^Qhh, Hhd^Qhh, Gs^Qhuf, Gs^Qhuf, Gd^Fts, Gd^Fts, Gd^Fts, Gs^Qhuf, Gs^Qhuf, Rb, Gd^Fts, Gd^Fts, Gd^Fts, Gd^Fts, Gs^Qhuf
Hhd^Qhh, Hhd^Qhh, Hhd^Qhh, Gs^Qhuf, Gs^Qhuf, Gs^Qhuf, Gd^Fts, Gd^Fts, Gd^Fts, Gd^Fts, Gs^Qhuf, Rb, Gd^Fts, Gd^Fts, Gd^Fts, Gs^Qhuf, Gs^Qhuf
Hhd^Qhh, Hhd^Qhh, Gs^Qhuf, Gs^Qhuf, Gd^Fts, Gd^Fts, Gd^Fts, Gd^Fts, Re^Qhuf, Gs^Qhuf, Gs^Qhuf, Rb, Gd^Fts, Gd^Fts, Gd^Fts, Gs^Qhuf, Gs^Qhuf
Gs^Qhuf, Gs^Qhuf, Gs^Qhuf, Gs^Qhuf, Gd^Fts, Gd^Fts, Gd^Fts, Gd^Fts, Gs^Qhuf, Gs^Qhuf, Rb, Rb, Gd^Fts, Re^Qhuf, Gd^Fts, Gd^Fts, Gs^Qhuf
Gs^Qhuf, Gs^Qhuf, Gs^Qhuf, Gd^Fts, Gd^Fts, Gd^Fts, Gd^Fts, Gd^Fts, Gd^Fts, Rb, Gd^Fts, Gd^Fts, Gd^Fts, Gd^Fts, Gd^Fts, Gd^Fts, Gs^Qhuf
Gs^Qhuf, Gs^Qhuf, Gd^Fts, Gd^Fts, Gd^Fts, Gd^Fts, Gd^Fts, Gd^Fts, Gs^Qhuf, Rb, Gd^Fts, Gd^Fts, Gd^Fts, Gd^Fts, Gd^Fts, Gd^Fts, Gs^Qhuf
Gs^Qhuf, Gs^Qhuf, Gd^Fts, Gs^Qhux, Gd^Fts, Gd^Fts, Gd^Fts, Gs^Qhuf, Re^Vct, Rb, Gd^Fts, Gd^Fts, Gd^Fts, Gd^Fts, Gd^Fts, Gd^Fts, Gs^Qhuf
Gd^Fts, Gd^Fts, Gd^Fts, Gd^Fts, Gs^Qhux, Gd^Fts, Gd^Fts, Gs^Qhuf, Gs^Qhuf, Rb, Gd^Fts, Gd^Fts, Gd^Fts, Gd^Fts, Gd^Fts, Gd^Fts, Gs^Qhuf
Gg, Gd^Fts, Gd^Fts, Gs^Qhux, Gd^Fts, Gd^Fts, Gs^Qhuf, Gs^Qhuf, Rb, Rb, Rb, Gd^Fts, Gd^Fts, Gd^Fts, Gd^Fts, Gs^Qhuf, Gs^Qhuf
Gd^Fts, Gd^Fts, Gd^Fts, Gd^Fts, Gd^Fts, Gd^Fts, Gs^Qhuf, Gs^Qhuf, Rb, Rb, Rb, Gd^Fts, Gd^Fts, Gd^Fts, Gd^Fts, Gs^Qhuf, Gs^Qhuf
Gd^Fts, Gs^Qhux, Gd^Fts, Gd^Fts, Gs^Qhuf, Gs^Qhuf, Rb, Rb, Gs^Qhuf, Gs^Qhuf, Gs^Qhuf, Rb, Rb, Gd^Fts, Gd^Fts, Gs^Qhuf, Gs^Qhuf
Gs^Qhuf, Gd^Fts, Gd^Fts, Gd^Fts, Gd^Fts, Gs^Qhuf, Rb, Gs^Qhuf, Gs^Qhuf, Gs^Qhuf, Gd^Fts, Rb, Rb, Gd^Fts, Gs^Qhuf, Gs^Qhuf, Gs^Qhuf
Rb, Gs^Qhuf, Rb, Gd^Vhr, Rb, Rb, Rb, Gd^Vhr, Gs^Qhuf, Gd^Fts, Gd^Fts, Gd^Fts, Rb, Gs^Qhuf, Gd^Vhr, Gs^Qhuf, Gs^Qhuf
Gs^Qhuf, Rb, Gs^Qhuf, Rb, Gs^Qhuf, Gs^Qhuf, Gs^Qhuf, Rb, Rb, Gs^Qhuf, Gs^Qhuf, Gs^Qhuf, Gs^Qhuf, Rb, Rb, Gs^Qhuf, Gs^Qhuf
Gs^Qhuf, Ce, Ce, Gs^Qhuf, Gs^Qhuf, Gs^Qhuf, Gs^Qhuf, Rb, Rb, Gs^Qhuf, Gs^Qhuf, Gs^Qhuf, Gs^Qhuf, Gs^Qhuf, Ce, Ce, Gs^Qhuf
Gs^Qhuf, Ce, 2 Ke, Ce, Gs^Qhuf, Gs^Qhuf, Gs^Qhuf, Gs^Qhuf, Gs^Qhuf, Rb, Rb, Gs^Qhuf, Gs^Qhuf, Ce, 1 Ke, Ce, Gs^Qhuf
Gs^Qhuf, Gs^Qhuf, Gs^Qhuf, Gs^Qhuf, Gs^Qhuf, Gs^Qhuf, Gs^Qhuf, Gs^Qhuf, Gs^Qhuf, Gs^Qhuf, Gs^Qhuf, Rb, Rb, Gs^Qhuf, Gs^Qhuf, Gs^Qhuf, Gs^Qhuf
Gs^Qhuf, Gs^Qhuf, Gs^Qhuf, Gs^Qhuf, Gs^Qhuf, Gs^Qhuf, Gs^Qhuf, Gs^Qhuf, Gs^Qhuf, Gs^Qhuf, Gs^Qhuf, Gs^Qhuf, Rb, Rb, Gs^Qhuf, Gs^Qhuf, Gs^Qhuf
