Xos^Qhh, Xos^Qhh, Xos^Qhh, Xos^Qhh, Xos^Qhh, Xos^Qhh, Xos^Qhh, Xos^Qhh, Xos^Qhh, Xos^Qhh, Xos^Qhh, Xos^Qhh, Xos^Qhh, Xos^Qhh, Urb, Urb, Urb, Xos^Qhh, Xos^Qhh, Xu, Xu, Xu, Ur^Qhu, Xu, Xu, Xu, Ur^Qhu, Xu, Xu, Ur^Qhu, Ur^Qhu, Ur^Qhu, Xu^Qhh, Xu^Qhh, Xu^Qhh, Qxu, Ql^Qhu, Qxu, Xu^Qhh
Xos^Qhh, Xos^Qhh, Xos^Qhh, Xos^Qhh, Xos^Qhh, Xos^Qhh, Xos^Qhh, Xos^Qhh, Xos^Qhh, Xos^Qhh, Uu^Vud, Xos^Qhh, Xos^Qhh, Xos^Qhh, Urb, Urb, Urb, Xos^Qhh, Xos^Qhh, Xos^Qhh, Xu, Ur^Qhu, Xu, Ur^Qhu, Ur^Qhu, Ur^Qhu, Ur^Qhu, Ur^Qhu, Ur^Qhu, Ur^Qhu, Ur^Qhu, Ur^Qhu, Xu^Qhh, Xu^Qhh, Xu^Qhh, Ql^Qhu, Ql^Qhu, Xu^Qhh, Xu^Qhh
Xos^Qhh, Xos^Qhh, Xos^Qhh, Xos^Qhh, Urb, Urb, Urb, Xos^Qhh, Urb, Urb, Urb, Urb, Xos^Qhh, Xos^Qhh, Urb, Urb, Urb, Xos^Qhh, Xos^Qhh, Xos^Qhh, Xu, Xu, Xoc, Xu, Xu, Ur^Qhu, Ur^Qhu, Ur^Qhu, Xu^Qhh, Xu^Qhh, Xu^Qhh, Xu^Qhh, Xu^Qhh, Xu^Qhh, Ql^Qhu, Ql^Qhu, Xu^Qhh, Xu^Qhh, Xu^Qhh
Xos^Qhh, Xos^Qhh, Xos^Qhh, Xos^Qhh, Urb, 1 Urb, Urb, Urb, Xos^Qhh, Urb, Uu^Vud, Urb, Urb, Xos^Qhh, Urb, Urb, Urb, Xos^Qhh, Xos^Qhh, Xos^Qhh, Xos^Qhh, Xos^Qhh, Urb, Xos^Qhh, Xos^Qhh, Xu, Ur^Qhu, Xu^Qhh, Xu^Qhh, Xu^Qhh, Xu^Qhh, Xu^Qhh, Xu^Qhh, Ql^Qhu, Xu^Qhh, Ql^Qhu, Xu^Qhh, Xu^Qhh, Xu^Qhh
Xos^Qhh, Xos^Qhh, Xos^Qhh, Xos^Qhh, Xos^Qhh, Urb, Xos^Qhh, Xos^Qhh, Xos^Qhh, Xos^Qhh, Xos^Qhh, Xos^Qhh, Xos^Qhh, Urb, Urb, Urb, Urb, Xos^Qhh, Xos^Qhh, Xos^Qhh, Xos^Qhh, Urb, Urb, Urb, Xos^Qhh, Xu, Ur^Qhu, Xu^Qhh, Xu^Qhh, Xu^Qhh, Xu^Qhh, Xu^Qhh, Ql^Qhu, Ql^Qhu, Xu^Qhh, Xu^Qhh, Xu^Qhh, Xu^Qhh, Xu^Qhh
Xos^Qhh, Xos^Qhh, Xos^Qhh, Xos^Qhh, Xos^Qhh, Xos^Qhh, Xos^Qhh, Xos^Qhh, Xos^Qhh, Xos^Qhh, Uu^Vud, Xos^Qhh, Xos^Qhh, Xos^Qhh, Urb, Urb, Urb, Xos^Qhh, Xos^Qhh, Xos^Qhh, Urb, Urb, Urb, Uu^Vud, Xos^Qhh, Xu, Ur^Qhu, Xu^Qhh, Xu^Qhh, Xu^Qhh, Ql^Qhu, Ql^Qhu, Ql^Qhu, Ql^Qhu, Xu^Qhh, Xu^Qhh, Uh^Qhh, Xu^Qhh, Uh^Qhh
Xos^Qhh, Xos^Qhh, Xos^Qhh, Xos^Qhh, Urb, Urb, Urb, Xos^Qhh, Urb, Urb, Urb, Urb, Urb, Urb, Urb, Urb, Urb, Xos^Qhh, Urb, Urb, Xos^Qhh, Xos^Qhh, Xos^Qhh, Xos^Qhh, Xos^Qhh, Xu, Xos^Qhh, Xu^Qhh, Uh^Qhh, Xu^Qhh, Ql^Qhu, Ql^Qhu, Ql^Qhu, Xu^Qhh, Uu^Qhh, Uh^Qhh, Uh^Br/, Uh^Br/, Uh^Qhh
Xos^Qhh, Xos^Qhh, Xos^Qhh, Xos^Qhh, Urb, Urb, Urb, Urb, Xos^Qhh, Urb, Uu^Vud, Urb, Xos^Qhh, Xos^Qhh, Urb, Urb, Urb, Urb, Xos^Qhh, Xos^Qhh, Xos^Qhh, Xos^Qhh, Xos^Qhh, Xos^Qhh, Xos^Qhh, Xos^Qhh, Uu^Vud, Uh^Qhh, Uh^Qhh, Ql^Qhu, Uu^Qhh, Ql^Qhu, Ql^Qhu, Uu^Qhh, Uu^Br/, Uu^Br/, Uu^Qhh, Uh^Qhh, Qlf
Xos^Qhh, Xos^Qhh, Xos^Qhh, Xos^Qhh, Urb, Urb, Xos^Qhh, Xos^Qhh, Xos^Qhh, Xos^Qhh, Xos^Qhh, Xos^Qhh, Xos^Qhh, Xos^Qhh, Urb, Urb, Urb, Xos^Qhh, Uu^Vud, Xos^Qhh, Ur^Br/, Xos^Qhh, Ur, Xos^Qhh, Urb, Uu, Uh^Br|, Uh^Qhh, Uh^Qhh, Ql^Qhu, Uu^Qhh, Uu^Qhh, Ql^Br/, Uu^Br/, Uu^Qhh, Uu^Br\, Uu^Br\, Uh^Qhh, Qlf
Xos^Qhh, Xos^Qhh, Xos^Qhh, Xos^Qhh, Urb, Xos^Qhh, Xos^Qhh, Xos^Qhh, Xos^Qhh, Xos^Qhh, Xos^Qhh, Xos^Qhh, Xos^Qhh, Xos^Qhh, Ur, Urb, Urb, Uu, Uu^Br/, Uu^Br/, Ur, Ur^Br\, Ur^Br\, Ur, Urb, Urb, Uu^Br|, Uh^Qhh, Ql^Qhu, Ql^Qhu, Urb^Br/, Urb^Br/, Ql^Qhu, Uu^Qhh, Uu^Qhh, Uu^Vu, Uu^Qhh, Cud^Qhh, Qlf
Xos^Qhh, Xos^Qhh, Xos^Qhh, Urb, Urb, Uu^Vud, Xos^Qhh, Xos^Qhh, Xos^Qhh, Xos^Qhh, Xos^Qhh, Xos^Qhh, Ur, Ur, Ur, Ur, Ur^Br/, Urb^Br/, Urb, Uu, Ur, Uu, Cud^Qhh, Ur^Br\, Ur^Br\, Urb, Urb^Br|, Uh^Qhh, Ur^Br/, Urb^Br/, Uu, Uu, Ql^Bs\, Ql^Qhu, Ql^Qhu, Uu^Qhh, Cud^Qhh, Cud^Qhh, Ql
Xos^Qhh, Xos^Qhh, Xos^Qhh, Urb, Urb, Urb, Xos^Qhh, Xos^Qhh, Xos^Qhh, Xos^Qhh, Xos^Qhh, Ur, Ur, Ur, Ur^Br/, Ur^Br/, Ur, Ur, Urb, Ur, Ur, Ur, Kud, Ur, Cud^Qhh, Ur^Br\, Urb^Br\, Uu^Br/, Urb, Ur, Ur, Ql, Ql, Ur, Ql^Qhu, Uu^Qhh, Uu^Qhh, Cud^Qhh, Qlf
Xos^Qhh, Xos^Qhh, Xos^Qhh, Xos^Qhh, Xos^Qhh, Xos^Qhh, Xos^Qhh, Xos^Qhh, Xos^Qhh, Xos^Qhh, Uu^Vud, Ur, Ur, Uu^Vud, Ur, Ur^Br\, Ur, Ur, Urb, Ur, Cud^Qhh, Ur, Cud^Qhh, Cud^Qhh, Ur^Br/, Ur^Br/, Ur, Urb^Br\, Urb^Br\, Ur, Ur, Ur, Ur, Ur, Ur, Ql^Qhu, Ql^Qhu, Ql^Qhu, Ql^Qhu
Xos^Qhh, Xos^Qhh, Xos^Qhh, Xos^Qhh, Xos^Qhh, Xos^Qhh, Xos^Qhh, Xos^Qhh, Xos^Qhh, Cud^Qhh, Cud^Qhh, Ur^Br\, Ur^Br\, Ur, Ur^Br/, Ur^Br|, Urb, Urb, Ur, Ur, Ur, Kud, Ur, Kud, Ur, Ur, Ur, Urb, Ur, Urb^Br\, Urb^Br\, Urb, Urb, Urb, Urb, Ur, Ql^Qhu, Ql^Qhu, Ql^Qhu
Xos^Qhh, Xos^Qhh, Xos^Qhh, Xos^Qhh, Xos^Qhh, Xos^Qhh, Xos^Qhh, Xos^Qhh, Uu, Uu, Uu, Cud^Qhh, Cud^Qhh, Ur^Br\, Urb^Br\, Urb^Br|, Ur, Ur, Ur, Ur, Ur, Cud^Qhh, Cud^Qhh, Ur, Ur, Ur, Ur, Ur, Ur, Urb, Ur^Br|, Ur^Br\, Ur^Br\, Ur, Ur, Ur, Ur, Ql^Qhu, Qlf
Xos^Qhh, Xos^Qhh, Xos^Qhh, Xos^Qhh, Xos^Qhh, Xos^Qhh, Uu^Vu, Uu, Uu, Uu, Uu, Uu, 2 Cud^Qhh, Cud^Qhh, Cud^Qhh, Uh^Br|, Uh^Br\, Uu^Vud, Urb, Ur, Urb, Ur, Ur, Ur, Ur, Ur, Ur, Ur, Urb, Uh, Ur^Br|, Uu^Vud, Ur, Ur^Br\, Ur^Br\, Ur, Ur, Cud, Qlf
Xos^Qhh, Xos^Qhh, Xos^Qhh, Xos^Qhh, Xos^Qhh, Uu, Uu, Uu, Ur, Uu, Uu, Uu, Uu, Uu, Uu, Cud^Qhh, Cud^Qhh, Urb^Br\, Urb^Br\, Urb, Ur, Urb, Ur, Ur, Ur, Ur, Uu^Vud, Ur, Urb, Ur, Ur^Br|, Ur, Ur, Ur, Ur, Ur^Br\, Ur^Br\, Cud, Qlf
Xos^Qhh, Xos^Qhh, Xos^Qhh, Xos^Qhh, Xos^Qhh, Uu, Uu, Ur, Uu, Uu, Uu, Uu, Uu, Uu, Uu, Uu, Uu, Cud^Qhh, Cud^Qhh, Ur^Br\, Ur^Br\, Ur, Ur, Ur, Ur, Ur, Ur, Ur, Urb, Ur, Ur^Br|, Ur, Ur, Cud, Ur, Ur, Ur, Cud, Xu^Qhh
Xos^Qhh, Xos^Qhh, Xos^Qhh, Xos^Qhh, Uu, Uu, Uu, Uu, Uu, Uu, Uu, Uu, Uu, Uu, Uu, Uu, Uu, Uu, Cud^Qhh, Cud^Qhh, Cud^Qhh, Uu^Vud, Xu^Qhh, Ur, Ur, Ur, Uu, Ur, Uu^Vud, Urb, Ur^Br|, Cud, Ur, Cud, Ur, Ur, Uu^Vud, Xu^Qhh, Xu^Qhh
Xos^Qhh, Xos^Qhh, Xos^Qhh, Xos^Qhh, Uu, Uu^Vu, Uu, Uu, Uu, Uu, Uu, Uu, Uu, Uu, Uu, Uu, Uu, Uu, Uu, Uu, Xu^Qhh, Xu^Qhh, Ql^Qhu, Xu^Qhh, Xu^Qhh, Uu, Xu^Qhh, Xu^Qhh, Ur, Ur^Br\, Ur^Br\, Ur, Ur, Ur, Xu^Qhh, Ur, Xu^Qhh, Xu^Qhh, Xu^Qhh
Uu, Uu, Uu, Uu, Ur, Uu, Uu, Uu, Uu, Uu, Uu, Uu, Uu, Uu, Uu, Uu, Uu, Uu, Uu, Xu^Qhh, Ql^Qhu, Ql^Qhu, Ql^Qhu, Ql^Qhu, Ql^Qhu, Xu^Qhh, Ql^Qhu, Xu^Qhh, Cud^Qhh, Cud^Qhh, Cud^Qhh, Ur^Br\, Ur^Br\, Xu^Qhh, Xu^Qhh, Xu^Qhh, Xu^Qhh, Xu^Qhh, Xu^Qhh
Uu, Uu, Ur, Ur, Cud, Uu, Uh, Uh, Ur, Uu, Uu, Ur, Ur, Ur, Uu, Uu, Uu, Uu, Uu, Xu^Qhh, Xu^Qhh, Ql^Qhu, Ql^Qhu, Ql^Qhu, Ql^Qhu, Ql^Qhu, Xu^Qhh, Xu^Qhh, Uu^Qhh, Uu^Qhh, Uu^Qhh, Cud^Qhh, Uu^Qhh, Xu^Qhh, Xu^Qhh, Xu^Qhh, Xu^Qhh, Xu^Qhh, Xu^Qhh
Uu, Uu, Uu, Uu, Cud, Uu, Uu, Uu, Ur, Uu, Cud, Uu, Uu, Uu, Uu, Uu, Uu, Uu, Uu, Uu^Vu, Xu^Qhh, Ql^Qhu, Ql^Qhu, Ql^Qhu, Ql^Qhu, Xu^Qhh, Uu^Qhh, Uu^Qhh, Uu^Vu, Uu^Qhh, Uu^Qhh, Uu^Qhh, Uu^Vu, Uu^Qhh, Xu^Qhh, Xu^Qhh, Xu^Qhh, Xu^Qhh, Xu^Qhh
Uu, Uu, Uu, Uu, Uu, Cud, Uu, Uu, Uu, Uu, Cud, Uu, Uu, Uu, Uu, Uu, Uu, Uu, Uu, Uu, Xu^Qhh, Ql^Qhu, Ql^Qhu, Ql^Qhu, Ql^Qhu, Xu^Qhh, Xu^Qhh, Uu^Qhh, Uu^Qhh, Uu^Qhh, Uu^Qhh, Uu^Qhh, Uu^Qhh, Uu^Qhh, Xu^Qhh, Xu^Qhh, Xu^Qhh, Xu^Qhh, Xu^Qhh
Uu, Uu, Uu, Uu, Cud, Uu, Uu, Uu^Vu, Ur, Uu, Uh, 3 Kud, Cud, Cud, Uu, Uu, Uu, Uu, Xu^Qhh, Xu^Qhh, Ql^Qhu, Ql^Qhu, Ql^Qhu, Ql^Qhu, Ql^Qhu, Ql^Qhu, Xu^Qhh, Cud, Uu^Qhh, Uu^Qhh, Cud, Uu^Qhh, Uu^Qhh, Xu^Qhh, Xu^Qhh, Xu^Qhh, Xu^Qhh, Xu^Qhh, Xu^Qhh
Uu, Uu, Uu, Uu, Uu, Cud, Uu, Uu, Ur, Uu, Uu, Uh, Cud, Uu, Uu, Uu, Uu, Uu^Vu, Xu^Qhh, Ql^Qhu, Ql^Qhu, Ql^Qhu, Xu^Qhh, Xu^Qhh, Xu^Qhh, Xu^Qhh, Uu^Qhh, Uu^Qhh, Uu^Qhh, Uu^Qhh, Cud, Uu^Qhh, Cud, Uu^Qhh, Uu^Qhh, Xu^Qhh, Xu^Qhh, Xu^Qhh, Xu^Qhh
Xu^Qhh, Uu, Uu, Cud, Xu^Qhh, Uh, Uh, Uu, Uu, Ur, Uu, Uu^Vu, Uu, Uu, Xu^Qhh, Uu, Xu^Qhh, Xu^Qhh, Ql^Qhu, Ql^Qhu, Ql^Qhu, Ql^Qhu, Xu^Qhh, Uu^Qhh, Uu^Qhh, Uu^Qhh, Uu^Qhh, Uu^Qhh, Uu^Qhh, Uu^Qhh, Uu^Qhh, Uu^Qhh, Uu^Qhh, Uu^Qhh, Uu^Qhh, Xu^Qhh, Xu^Qhh, Xu^Qhh, Xu^Qhh
Xu^Qhh, Xu^Qhh, Xu^Qhh, Xu^Qhh, Xu^Qhh, Uh, Uh, Uu, Uu, Uu, Uu, Uu, Cud, Uu, Xu^Qhh, Xu^Qhh, Ql^Qhu, Ql^Qhu, Ql^Qhu, Ql^Qhu, Xu^Qhh, Xu^Qhh, Uh^Qhh, Uh^Qhh, Uu^Qhh, Uu^Qhh, Uu^Qhh, Uu^Qhh, Uu^Qhh, Uu^Qhh, Uu^Qhh, Uu^Qhh, Uu^Qhh, Cud, Xu^Qhh, Xu^Qhh, Xu^Qhh, Xu^Qhh, Xu^Qhh
Xu^Qhh, Xu^Qhh, Xu^Qhh, Xu^Qhh, Xu^Qhh, Uh, Uh, Uu^Vu, Uu, Uu, Uh, Uh, Cud, Xu^Qhh, Xu^Qhh, Xu^Qhh, Ql^Qhu, Ql^Qhu, Xu^Qhh, Ql^Qhu, Xu^Qhh, Uh^Qhh, Uu^Qhh, Uh^Qhh, Uu^Qhh, Uu^Qhh, Re^Qhh, Uu^Qhh, Uu^Qhh, Uu^Qhh, Uh^Qhh, Uu^Qhh, Xu^Qhh, Uu^Qhh, Xu^Qhh, Xu^Qhh, Xu^Qhh, Uu^Qhh, Uu^Qhh
Xu^Qhh, Xu^Qhh, Xu^Qhh, Xu^Qhh, Xu^Qhh, Xu^Qhh, Xu^Qhh, Uu, Cud, Cud, Qxu, Uh, Uh, Uh, Ql^Qhu, Ql^Qhu, Uu^Qhh, Xu^Qhh, Uh^Qhh, Xu^Qhh, Uu^Qhh, Uu^Qhh, Uu^Qhh, Uu^Qhh, Uu^Qhh, Re^Qhh, Re^Qhh, Re^Qhh, Uh^Qhh, Uh^Qhh, Xu^Qhh, Uu^Qhh, Xu^Qhh, Xu^Qhh, Xu^Qhh, Xu^Qhh, Uu^Qhh, Uu^Qhh, Uu^Qhh
Xu^Qhh, Xu^Qhh, Xu^Qhh, Xu^Qhh, Xu^Qhh, Xu^Qhh, Xu^Qhh, Xu^Qhh, Cud, Cud, Cud, Uh, Uh, Ql^Bs\, Uh, Uu^Qhh, Uu^Qhh, Uh^Qhh, Uu^Qhh, Uu^Qhh, Uu^Qhh, Re^Qhh, Uu^Qhh, Uu^Qhh, Re^Qhh, Re^Qhh, Re^Qhh, Uu^Qhh, Uh^Qhh, Uh^Qhh, Xu^Qhh, Xu^Qhh, Xu^Qhh, Xu^Qhh, Uu^Qhh, Uu^Qhh, Re^Qhh, Uu^Qhh, Uu^Qhh
Xu^Qhh, Xu^Qhh, Xu^Qhh, Xu^Qhh, Xu^Qhh, Xu^Qhh, Xu^Qhh, Xu^Qhh, Cud, Uh, Uh, Uh, Ql^Bs\, Ql^Bs\, Uu^Qhh, Uu^Qhh, Re^Qhh, Uu^Qhh, Re^Qhh, Uu^Qhh, Uu^Qhh, Uu^Qhh, Cud, Uu^Qhh, Uu^Qhh, Uu^Qhh, Uu^Qhh, Uu^Qhh, Uu^Vu, Xu^Qhh, Xu^Qhh, Xu^Qhh, Uu^Qhh, Uu^Qhh, Uu^Qhh, Uu^Qhh, Re^Qhh, Uu^Qhh, Uh^Qhh
Xu^Qhh, Xu^Qhh, Xu^Qhh, Xu^Qhh, Xu^Qhh, Xu^Qhh, Xu^Qhh, Cud, Uh, Uh, Ql^Bs\, Ql^Bs\, Uh, Uh, Uu^Qhh, Uu^Qhh, Re^Qhh, Re^Qhh, Uu^Qhh, Uu^Vu, Uu^Qhh, Cud, Cud, 4 Kud, Cud, Uu^Qhh, Uu^Qhh, Uu^Qhh, Xu^Qhh, Xu^Qhh, Xu^Qhh, Xu^Qhh, Uu^Qhh, Uu^Vu, Uu^Qhh, Re^Qhh, Re^Qhh, Uu^Qhh, Uh^Qhh
Ql, Xu^Qhh, Ql, Xu^Qhh, Xu^Qhh, Xu^Qhh, Xu^Qhh, Uu, Uh, Uh, Ql, Uu, Uh, Uh, Uh, Re^Qhh, Uu^Qhh, Re^Qhh, Uu^Qhh, Uu^Qhh, Uu^Qhh, Uu^Qhh, Uu^Qhh, Uu^Qhh, Uu^Qhh, Cud, Uu^Qhh, Uu^Qhh, Xu^Qhh, Xu^Qhh, Xu^Qhh, Uu^Qhh, Uu^Qhh, Uu^Qhh, Uh^Qhh, Uh^Qhh, Re^Qhh, Uu^Qhh, Uh^Qhh
Ql, Ql, Ql, Ql, Ql, Xu^Qhh, Xu^Qhh, Xu^Qhh, Xu^Qhh, Uh, Uh, Ql, Ql, Uh, Uu, Re^Qhh, Uu^Qhh, Uu^Qhh, Uu^Qhh, Uh^Qhh, Uu^Qhh, Uu^Qhh, Re, Uu^Qhh, Uu^Qhh, Uu^Qhh, Uu^Qhh, Xu^Qhh, Xu^Qhh, Xu^Qhh, Xu^Qhh, Uu^Qhh, Uu^Qhh, Uh^Qhh, Uh^Qhh, Re^Qhh, Uu^Qhh, Uh^Qhh, Uh^Qhh
Ql, Ql, Ql, Ql, Ql, Ql, Ql, Xu^Qhh, Xu^Qhh, Xu^Qhh, Xu^Qhh, Uh, Ql, Uu, Re^Qhh, Re^Qhh, Uu^Qhh, Uu^Qhh, Uu^Qhh, Uu^Qhh, Re, Re, Uu^Qhh, Uu^Qhh, Uu^Qhh, Uu^Qhh, Uu^Qhh, Cud, Re, Uu^Qhh, Uu^Qhh, Uu^Qhh, Uu^Qhh, Uu^Qhh, Uu^Qhh, Uu^Qhh, Uu^Qhh, Uh^Qhh, Uh^Qhh
