Ss, Ss, Rb, Ss, Ss, Ss, Ss^Bw|, Ss, Gs, Ss, Sm, Ww, Sm, Sm, Sm, Ss, Sm, Rr, Gs, Gs, Gs, Rb, Gs, Gs, Gs, Gs, Gs, Hh, Hh, Gs^Fp, Gs^Fp, Hh
Gs, Gs, Rb, Gs, Gs, Gs, Co, Gs, Gs, Ss, Sm, Ww, Ww, Ww, Sm, Sm, Co, Gs, Gs, Gs^Vc, Gs, Rb, Gs, Gs, Gs^Fp, Gs, Gs, Gs, Hh, Hh, Hh, Gs^Fp
Gs, Gs, Rb, Gs, Gs, Co, 3 Ko, Gs, Gs, Gs^Fp, Sm, Sm, Ww, Sm, Sm, Co, Gg, Co, Gs, Gs, Gs, Rb, Gs, Gs^Fp, Gs^Fp, Gs^Fp, Gs^Fp, Gs, Gs^Vc, Hh, Gs^Fp, Gs^Fp
Gs, Gs, Rb, Gs, Co, Co, Gs, Gs, Gs, Gs, Sm, Ww, Sm, Sm, Ss^Bw/, Co, Co, 4 Ko, Gs, Gs, Gs, Rb, Gs, Gs^Fp, Gs^Fp, Gs^Fp, Gs^Fp, Gs, Gs, Hh, Hh, Hh
Gs, Gs, Rb, Gs, Gs, Co, Gs, Gs, Gs, Gs, Sm, Ww^Bw\, Sm, Ss^Bw/, Ss, Co, Rb, Gs, Gs, Gs, Gs, Rb, Gs, Gs^Fp, Gs^Fp, Gs^Fp, Gs^Fp, Gs^Fp, Gs, Hh, Hh, Hh
Gs, Gs^Vc, Gs, Rb, Rb, Gs, Gs, Gs, Gs^Vc, Gs, Sm, Ww, Ww, Sm, Sm, Rb, Ss, Rb, Rb, Gs, Gs^Vc, Rb, Gs, Gs^Fp, Gs^Fp, Gs^Fp, Gs^Fp, Gs^Fp, Gs, Gs, Hh, Hh
Gs, Gs, Gs, Gs, Gs, Rb, Rb, Gs, Gs, Gs, Rb, Sm, Sm^Bw/, Ww^Bw/, Ww, Sm, Ss, Ss, Rb, Gs, Rb, Rb, Gs^Fp, Gs^Fp, Gs^Fp, Gs^Fp, Gs^Fp, Gs, Gs, Gs, Gs, Hh
Gll^Fmf, Gs, Gs, Gs, Gs, Gs, Gs^Fp, Rb, Rb, Rb, Gs^Fp, Rb, Ss, Sm, Ww, Sm, Sm, Ss, Gs^Fp, Rb, Rb, Gs, Gs^Fp, Gs^Fp, Gs^Fp, Gs^Fp, Gs, Gs, Gs, Gs, Gs, Hh
Gll^Fmf, Gll^Fmf, Gs, Gs, Gs, Gs, Gs^Fp, Gs^Fp, Rb, Gs^Fp, Gs^Fp, Ss, Ss, Sm, Ww, Ww, Sm, Gs, Gs, Gs, Rb, Gs, Gs^Fp, Gs^Fp, Gs^Fp, Gs, Gs^Vc, Gs, Gs, Gs, Gs, Hh
Gll^Fmf, Gll^Fmf, Gs, Gs, Gs, Gs, Gs^Fp, Gs^Fp, Rb, Gs^Fp, Gs^Fp, Gs^Fp, Ss, Sm, Ww, Ww, Sm, Gs, Gs, Gs, Rb, Gs, Gs^Fp, Gs^Fp, Gs, Gs, Gs, Gs, Gs, Gs, Gs, Gs
Gll^Fmf, Gll^Fmf, Gll^Fmf, Gs, Gs, Gs, Gs, Gs, Rb, Gs^Fp, Gs^Fp, Gs^Fp, Gs, Sm, Ww, Wo, Ww, Sm, Sm, Gs, Gs, Rb, Rb, Gs, Gs, Gs, Gs, Gs, Gs, Gs, Gs^Fp, Gs
Gll^Fmf, Gll^Fmf, Gll^Fmf, Gll^Fmf, Gll^Fmf, Gs, Gs, Gs, Rb, Gs^Fp, Gs^Fp, Gs^Fp, Gs, Sm, Ww, Wo, Wo, Ww, Sm, Gs, Rb, Rb, Ce, Rb, Rb, Gs, Gs, Gs, Gs, Gs^Fp, Gs^Fp, Gs^Fp
Gll^Fmf, Gll^Fmf, Gll^Fmf, Gll^Fmf, Gll^Fmf, Gs, Gs, Gs, Rb, Gs^Vc, Gs, Gs, Gs, Sm, Sm, Ww, Ww, Ww, Ww^Bw/, Sm^Bw/, Gs, Ce, Ce, Gs, Gs, Rb, Rb, Gs, Gs, Gs^Fp, Gs^Fp, Gs^Fp
Gll^Fmf, Gll^Fmf, Gll^Fmf, Gll^Fmf, Gll^Fmf, Gll^Fmf, Gll^Fmf, Gs, Gs, Rb, Rb, Rb, Rb, Gs, Gs, Sm, Ww^Bw/, Gs^Fp, Ww^Vm, Sm, Sm, Rp, Ce, Gs, Gs, Gs, Gs, Rb, Rb, Gs, Gs^Fp, Gs^Fp
Hh, Gll^Fmf, Gll^Fmf, Gll^Fmf, Gll^Fmf, Gll^Fmf, Gll^Fmf, Gs, Gs, Gs, Gs, Gs^Fp, Gs^Fp, Rb, Rb, Sm^Bw/, Sm, Ww, Wo, Ww, Sm, Ce, 2 Ket, Ce, Ss, Gs, Gs^Fp, Gs^Vc, Rb, Gs, Gs, Gs^Fp
Hh, Gll^Fmf, Hh, Gll^Fmf, Gll^Fmf, Gll^Fmf, Gll^Fmf, Gs^Fp, Gs, Gs, Gs, Gs^Fp, Gs^Fp, Gs, Rb, Gs, Sm, Ww, Ww^Bw/, Ww^Bw\, Sm, Ce, Ce, Ce, Sm, Ss, Gs^Fp, Gs, Rb, Gs, Gs, Gs^Fp
Hh, Hh, Hh, Hh, Gll^Fmf, Gll^Fmf, Gll^Fmf, Gs^Fp, Gs^Fp, Gs, Gs, Gs, Gs^Fp, Gs^Fp, Rb, Gs, Rb, Sm^Bw/, Ww, Ww, Ww, Sm, Sm, Sm, Sm, Ss, Ss, Gs, Rb, Rb, Rb, Gs
Hh, Hh, Hh, Hh, Hh, Gll^Fmf, Gll^Fmf, Gs^Fp, Gs, Gs, Gs, Gs, Gs, Gs^Fp, Rb, Rb, Gs, Sm, Wo, Ww, Ww, Wwf, Ww, Wo, Sm, Ss, Sm^Bw/, Ss^Bw/, Ss, Gs^Vc, Gs, Rb
Mm, Hh, Hh, Hh, Hh, Gll^Fmf, Gll^Fmf, Gll^Fmf, Gll^Fmf, Gs, Gs, Gs^Vc, Gs, Gs, Rb, Gs, Sm, Sm, Wo, Wo, Ds, Ds, Ds, Wo, Wo^Bw/, Sm^Bw/, Wo, Sm, Sm, Ss, Gs, Gs
Mm, Mm, Mm, Hh, Hh, Hh, Gll^Fdf, Gll^Fmf, Gs^Vc, Gs, Gs, Gs, Gs, Gs, Rb, Gs, Sm, Ww, Ww, Ds, Gs^Vc, Chr, Chr, Ds, Ww^Vm, Wo, Wo, Ww, Sm, Ss, Gs, Gs
Mm, Mm, Mm, Mm, Hh, Hh, Hh, Gll^Fmf, Gll^Fmf, Gll^Fmf, Gll^Fmf, Gs, Gs, Rb, Gs, Ww^Ewl, Sm, Wo, Wo, Ds, Gg, 1 Khr, Chr, Ds, Wo, Wo, Ww, Ww, Sm, Ss, Hh, Gs
Mm, Mm, Mm, Mm, Mm, Hh, Hh, Hh, Hh, Gll^Fmf, Gll^Fmf, Gll^Fmf, Gll^Fmf, Rb, Gs, Ss, Ss, Sm, Ww^Bw/, Ds, Ds, Chr, Ds, Ds, Wo, Wo, Ww, Sm, Ss, Ss, Hh, Hh
Mm, Mm, Mm, Mm, Mm, Mm, Hh, Hh, Hh, Hh, Gll^Fmf, Gll^Fmf, Gll^Fmf, Rb, Rb, Gs, Rb, Sm^Bw/, Sm, Ww, Ww, Ds, Wo, Wo, Wo, Wo, Sm, Sm, Ss, Hh, Mm, Mm
Mm, Mm, Mm, Mm, Mm, Mm, Mm, Hh, Hh, Hh, Gll^Fmf, Gll^Fmf, Gll^Fmf, Gll^Fmf, Gll^Fmf, Rb, Rb, Gs, Gs, Sm, Ww^Ewf, Ww, Ww, Ww^Vm, Sm, Sm, Ss, Ss, Hh, Mm, Mm, Mm
Mm^Xm, Mm^Xm, Mm^Xm, Mm, Mm, Mm, Mm, Mm, Hh, Hh, Hh, Gll^Fmf, Gll^Fmf, Gll^Fmf, Gll^Fmf, Gll^Fmf, Rb, Gs, Gs, Gs, Ww^Ewf, Ww^Ewf, Ww, Ww, Sm, Ss, Hh, Hh, Mm, Mm, Mm, Mm^Xm
Mm^Xm, Mm^Xm, Mm^Xm, Mm^Xm, Mm^Xm, Mm, Mm, Mm, Mm, Hh, Hh, Hh, Gll^Fmf, Gll^Fmf, Gll^Fmf, Gll^Fmf, Rb, Gs, Gs^Vc, Gs, Gs, Sm, Ww, Ww, Sm, Ss, Hh, Hh, Mm, Mm, Mm^Xm, Mm^Xm
Mm^Xm, Mm^Xm, Mm^Xm, Mm^Xm, Mm^Xm, Mm, Mm, Mm, Mm, Mm, Hh, Hh, Hh, Gll^Fmf, Gll^Fmf, Gll^Fmf, Rb, Gd, Gs, Gs, Sm, Sm, Ww, Sm, Ss, Ss, Mm, Mm, Mm, Mm, Mm^Xm, Mm^Xm
Mm^Xm, Mm^Xm, Mm^Xm, Mm^Xm, Mm^Xm, Mm^Xm, Mm^Xm, Mm, Mm, Mm, Mm, Hh, Hh, Hh, Hh, Gll^Fmf, Rb, Re, Gs^Fp, Gs, Sm, Ww, Sm, Sm, Ss, Hh, Mm, Mm, Mm^Xm, Mm^Xm, Mm^Xm, Mm^Xm
Mm^Xm, Mm^Xm, Mm^Xm, Mm^Xm, Mm^Xm, Mm^Xm, Mm^Xm, Mm^Xm, Mm, Mm, Mm, Mm, Hh, Hh, Hh, Gll^Fmf, Rb, Re, Gs^Fp, Sm, Ww, Ww, Sm, Ss, Mm, Mm, Mm, Mm, Mm^Xm, Mm^Xm, Mm^Xm, Mm^Xm
