Hd, Hd, Mdd, Gg, Mdd, Dd^Ftd, Dd^Ftd, Dd^Ftd, Dd^Ftd, Gg, Gs^Ftp, Re, Re, Gg, Dd^Ftd, Dd^Ftd, Dd^Ftd, Dd^Ftd, Dd^Ftd, Dd^Ftd, Rb, Dd^Ftd, Gs^Ftp, Dd^Ftd, Dd^Ftd, Gg, Dd^Ftd, Dd^Ftd, Hhd, Mdd, Mdd, Mdd, Mdd, Mdd, Mdd, Mdd, Mdd
Mdd^Xm, Mdd^Xm, Mdd^Xm, Mdd, Mdd, Mdd, Mdd, Dd^Ftd, Dd^Ftd, Dd^Ftd, Gs^Ftp, Re, Re, Dd^Ftd, Dd^Ftd, Dd^Ftd, Dd^Ftd, Dd^Ftd, Dd^Ftd, Dd^Ftd, Rb, Dd^Ftd, Gs^Ftp, Dd^Ftd, Dd^Ftd, Dd^Ftd, Hhd, Hhd, Hhd, Mdd, Mdd, Mdd, Mdd^Xm, Mdd^Xm, Mdd^Xm, Mdd^Xm, Mdd^Xm
Mdd^Xm, Mdd^Xm, Mdd^Xm, Mdd^Xm, Mdd, Mdd, Mdd, Dd^Ftd, Dd^Ftd, Dd^Ftd, Gs^Ftp, Re, Re, Dd^Ftd, Dd^Ftd, Dd^Ftd, Dd^Ftd, Dd^Ftd, Dd^Ftd, Dd^Ftd, Rb, Dd^Ftd, Gs^Ftp, Gs^Ftp, Hhd, Hhd, Hhd, Hhd, Hhd, Mdd, Mdd, Mdd, Mdd^Xm, Mdd^Xm, Mdd^Xm, Mdd^Xm, Mdd^Xm
Mdd, Mdd^Xm, Mdd^Xm, Mdd^Xm, Mdd, Mdd, Mdd, Mdd, Gd^Vo, Dd^Ftd, Gs^Ftp, Re, Rb, Dd^Ftd, Dd^Ftd, Dd^Ftd, Dd^Ftd, Dd^Ftd, Gs^Ftp, Dd^Ftd, Rb, Dd^Ftd, Dd^Ftd, Gs^Ftp, Gs^Ftp, Hhd, Hhd, Hhd, Hhd, Mdd, Mdd^Xm, Mdd^Xm, Mdd^Xm, Mdd^Xm, Mdd^Xm, Mdd^Xm, Mdd^Xm
Mdd, Mdd, Mdd, Mdd, Mdd, Mdd, Mdd, Mdd, Dd^Ftd, Dd^Ftd, Gs^Ftp, Re, Dd^Ftd, Rb, Rb, Dd^Ftd, Gs^Ftp, Gs^Ftp, Ww, Gs^Ftp, Ww^Bw|, Gs^Ftp, Gs^Ftp, Dd^Ftd, Gs^Ftp, Gs^Ftp, Hhd, Hhd, Hhd, Mdd, Mdd^Xm, Mdd^Xm, Mdd^Xm, Mdd^Xm, Mdd^Xm, Mdd^Xm, Mdd^Xm
Mdd, Mdd, Mdd, Mdd, Mdd, Mdd, Dd^Ftd, Dd^Ftd, Dd^Ftd, Gs^Ftp, Gs^Ftp, Re, Dd^Ftd, Dd^Ftd, Gs^Ftp, Gs^Ftp, Ww^Bw\, Ww, Gd^Vo, Ww, Gs^Ftp, Ww, Ww, Gs^Ftp, Dd^Ftd, Gs^Ftp, Gs^Ftp, Gd^Vo, Hhd, Mdd, Mdd^Xm, Mdd^Xm, Mdd^Xm, Mdd^Xm, Mdd^Xm, Mdd^Xm, Mdd^Xm
Mdd, Mdd, Dd^Ftd, Dd^Ftd, Dd^Ftd, Dd^Ftd, Dd^Ftd, Dd^Ftd, Dd^Ftd, Gs^Ftp, Gs^Ftp, Re, Dd^Ftd, Gs^Ftp, Ww, Gs^Ftp, Ww, Gs^Ftp, Ce, Gs^Ftp, 4 Ke, Gs^Ftp, Ww, Gs^Ftp, Gs^Ftp, Dd^Ftd, Gs^Ftp, Hhd, Hhd, Mdd, Mdd, Mdd^Xm, Mdd^Xm, Mdd^Xm, Mdd, Mdd^Xm, Mdd
Dd^Ftd, Dd^Ftd, Gs^Ftp, Dd^Ftd, Gs^Ftp, Dd^Ftd, Gs^Ftp, Gs^Ftp, Gs^Ftp, Gs^Ftp, Gs^Ftp, Re, Gd^Vo, Gs^Ftp, Ww, Gs^Ftp, Ww, Gs^Ftp, Ce, Ce, Ce, Gs^Ftp, Gs^Ftp, Ww, Gs^Ftp, Dd^Ftd, Dd^Ftd, Gs^Ftp, Dd^Ftd, Hhd, Hhd, Mdd, Hhd, Mdd, Hhd, Mdd, Mdd
Gs^Ftp, Gs^Ftp, Gs^Ftp, Gs^Ftp, Gs^Ftp, Gs^Ftp, Gs^Ftp, Gs^Ftp, Gs^Ftp, Gs^Ftp, Gs^Ftp, Re, Gs^Ftp, Gs^Ftp, Gs^Ftp, Gs^Ftp, Gs^Ftp, Gs^Ftp, Ww^Bw/, Gs^Ftp, Ww, Ce, Gs^Ftp, Ww, Gs^Ftp, Dd^Ftd, Dd^Ftd, Gs^Ftp, Dd^Ftd, Dd^Ftd, Hhd, Hhd, Hhd, Hhd, Hhd, Hhd, Hhd
Gs^Ftp, Gs^Ftp, Gd^Vo, Gs^Ftp, Gs^Ftp, Gs^Ftp, Gs^Ftp, Gs^Ftp, Gs^Ftp, Gs^Ftp, Gs^Ftp, Re, Gs^Ftp, Rd, Rd, Ww, Ww, Ww^Bw|, Ww, Gs^Ftp, Gs^Ftp, Ww, Ww, Ww^Bw\, Re, Gd^Vo, Dd^Ftd, Gs^Ftp, Dd^Ftd, Dd^Ftd, Dd^Ftd, Hhd, Hhd, Hhd, Hhd, Hhd, Dd^Ftd
Gs^Ftp, Gs^Ftp, Gs^Ftp, Gs^Ftp, Gs^Ftp, Gs^Ftp, Gs^Ftp, Gs^Ftp, Gs^Ftp, Gs^Ftp, Gs^Ftp, Re, Re, Gs^Ftp, Gs^Ftp, Gs^Ftp, Gs^Ftp, Ww^Bw/, Gs^Ftp, Gs^Ftp, Gs^Ftp, Ww, Gs^Ftp, Ww, Gs^Ftp, Re, Re, Gs^Ftp, Dd^Ftd, Dd^Ftd, Dd^Ftd, Dd^Ftd, Dd^Ftd, Dd^Ftd, Dd^Ftd, Dd^Ftd, Dd^Ftd
Gs^Ftp, Gs^Ftp, Re, Re, Re, Gs^Ftp, Re, Gs^Ftp, Re, Gs^Ftp, Re, Re, Gs^Fds, Re, Re, Gs^Ftp, Re, Rd, Gs^Ftp, Gs^Ftp, Gs^Ftp, Gs^Ftp, Dd^Ftd, Gs^Ftp, Dd^Ftd, Dd^Ftd, Dd^Ftd, Re, Re, Dd^Ftd, Gs^Ftp, Dd^Ftd, Gs^Ftp, Dd^Ftd, Gs^Ftp, Gs^Ftp, Gs^Ftp
Re, Re, Gg, Gs^Fp, Gs^Fp, Re, Gs^Fds, Re, Re, Re, Gs^Fds, Gs^Fds, Gs^Fds, Gs^Fds, Gs^Fds, Re, Re, Re, Gs^Ftp, Gs^Ftp, Gs^Ftp, Dd^Ftd, Dd^Ftd, Dd^Ftd, Dd^Ftd, Dd^Ftd, Dd^Ftd, Gs^Ftp, Gs^Ftp, Re, Re, Gs^Ftp, Gs^Ftp, Gd^Vo, Gs^Ftp, Gs^Ftp, Gs^Ftp
Gs^Fp, Gg, Gs^Fp, Gg, Gs^Fp, Gs^Fds, Gs^Fds, Gs^Fds, Gs^Fds, Gg, Gs^Fds, Gs^Fds, Gs^Fds, Gg^Fet, Gs^Fds, Gs^Fds, Gs^Fds, Re, Re, Gs^Ftp, Gs^Ftp, Gs^Ftp, Gs^Ftp, Dd^Ftd, Dd^Ftd, Dd^Ftd, Dd^Ftd, Dd^Ftd, Gs^Ftp, Gs^Ftp, Gs^Ftp, Re, Re, Gs^Ftp, Gs^Ftp, Gs^Ftp, Gs^Ftp
Gg, Gs^Fp, Hh, Gg^Ve, Gs^Fp, Gg, Gg, Gg, Gs^Fds, Gs^Fds, Gs^Fds, Gs^Fds, Gs^Fds, Gs^Fds, Gs^Fds, Gs^Fds, Gg, Re, Re, Gs^Ftp, Gs^Ftp, Gs^Ftp, Gs^Ftp, Gs^Ftp, Gs^Ftp, Gs^Ftp, Gs^Ftp, Gs^Ftp, Gs^Ftp, Gs^Ftp, Gs^Ftp, Gs^Ftp, Gs^Ftp, Re, Gs^Ftp, Gs^Ftp, Gs^Ftp
Hh, Hh, Gg, Gg, Gs^Fp, Gg^Fet, Gg, Gs^Fds, Gs^Fds, Gs^Fds, Gs^Fds, Gs^Fds, Gs^Fds, Gs^Fds, Gs^Fds, Gs^Fds, Gs^Fds, Gs^Fds, Gs^Fds, Re, Re, Gs^Ftp, Gs^Ftp, Gs^Ftp, Gs^Ftp, Gs^Ftp, Gs^Ftp, Gs^Ftp, Gs^Ftp, Gs^Ftp, Re, Re, Re, Re, Re, Re, Re
Gs^Fp, Gs^Fp, Hh, Gs^Fp, Gg, Gs^Fp, Gg, Gs^Fds, Gs^Fds, Gs^Fds, Gs^Fds, Gs^Fds, Gs^Fds, Gg, Gs^Fds, Gs^Fds, Gs^Fds, Gs^Fds, Cv, Gs^Fds, Re, Re, Re, Gs^Ftp, Re, Gs^Ftp, Re, Re, Re, Re, Re, Re, Gg^Ve, Re, Hh, Re, Hh
Hh, Hh, Gs^Fp, Gs^Fp, Hh, Gs^Fp, Hh, Gs^Fds, Gs^Fds, Gs^Fds, Gs^Fds, Gs^Fds, Gs^Fds, Gg^Fet, Gs^Fds, Gs^Fds, Gs^Fds, Cv, 2 Kv, Cv, Re, Hh, Hh, Re, Gs^Fp, Re, Gs^Fp, Gs^Fp, Hh, Gs^Fp, Hh, Gs^Fp, Hh, Gs^Fp, Hh, Gs^Fp, Hh
Hh, Gs^Fp, Gs^Fp, Gg^Ve, Gs^Fp, Hh, Hh, Gs^Fds, Gs^Fds, Gs^Fds, Gs^Fds, Gs^Fds, Gs^Fds, Gs^Fds, Gs^Fds, Gs^Fds, Gs^Fds, Cv, Cv, Cv, Re, Gs^Fp, Hh, Hh, Gs^Fp, Gs^Fp, Hh, Hh, Hh, Hh, Mm, Mm, Mm, Hh, Mm, Hh, Hh
Hh, Hh, Hh, Hh, Hh, Gs^Fp, Hh, Gg, Gs^Fds, Gs^Fds, Hh, Gg, Gs^Fds, Hh, Gg^Ve, Gs^Fds, Hh, Gs^Fds, Hh, Gs^Fp, Re, Gg^Ve, Gs^Fp, Gs^Fp, Gs^Fp, Gs^Fp, Hh, Hh, Mm, Mm, Mm, Mm, Mm^Xm, Mm, Mm, Mm, Mm
Mm, Mm, Mm, Mm, Hh, Hh, Hh, Gs^Fds, Gg^Fet, Gs^Fds, Gs^Fds, Hh, Hh, Hh, Hh, Gs^Fds, Hh, Gg^Ve, Gg, Hh, Re, Hh, Gs^Fp, Gs^Fp, Gs^Fp, Hh, Mm, Mm, Mm, Mm, Mm^Xm, Mm^Xm, Mm^Xm, Mm^Xm, Mm, Mm, Mm
Mm, Mm, Mm, Mm, Mm, Mm, Mm, Hh, Gg, Gs^Fds, Hh, Gg, Gs^Fds, Gs^Fds, Gs^Fds, Gs^Fds, Hh, Hh, Hh, Re, Gs^Fp, Hh, Gs^Fp, Gs^Fp, Gs^Fp, Hh, Mm, Mm, Mm, Mm, Mm, Mm^Xm, Mm, Mm, Mm, Mm, Mm
Mm, Mm, Mm, Mm, Mm, Mm, Mm, Hh, Hh, Gs^Fds, Hh, Hh, Gs^Fds, Gs^Fds, Gg, Gs^Fds, Hh, Gs^Fp, Gs^Fp, Re, Hh, Hh, Gg^Ve, Hh, Gg^Ve, Hh, Hh, Mm, Mm, Mm, Mm, Mm, Mm, Mm, Mm, Mm, Mm
Mm, Mm, Mm, Mm, Mm, Mm, Mm, Mm, Mm, Hh, Hh, Hh, Hh, Hh, Gg^Ve, Gs^Fds, Gs^Fds, Hh, Gs^Fp, Re, Re, Gs^Fp, Hh, Hh, Hh, Hh, Hh, Hh, Hh, Mm, Mm, Mm, Mm, Mm, Mm, Mm, Mm^Xm
Mm, Mm, Mm, Mm, Mm, Mm, Mm, Mm, Hh, Hh, Ds, Hh, Hh, Hh, Hh, Gs^Fds, Gg, Gg^Fet, Gs^Fp, Gs^Fp, Re, Gs^Fp, Gs^Fp, Hh, Gs^Fp, Gs^Fp, Hh, Hh, Gs^Fp, Hh, Hh, Mm, Mm, Mm, Mm^Xm, Mm^Xm, Mm^Xm
Mm, Mm, Mm, Mm, Mm, Mm, Hh, Hh, Ds, Ds, Ds, Hh, Hh, Hh, Hh, Hh, Gs^Fp, Gs^Fp, Hh, Hh, Gg, Re, Gs^Fp, Hh, Gs^Fp, Hh, Hh, Gs^Fp, Gs^Fp, Gs^Fp, Gs^Fp, Hh, Mm, Mm, Mm^Xm, Mm^Xm, Mm^Xm
Mm, Mm, Mm, Mm, Mm, Hh, Ds, Ds, Wwrt, Ww, Ww, Ds, Ds, Hh, Hh, Gg, Gs^Fp, Gs^Fp, Hh, Hh^Vhh, Hh, Re, Hh, Gs^Fp, Hh, Gs^Fp, Hh, Gg^Fet, Gs^Fp, Hh, Hh, Hh, Mm, Mm, Mm^Xm, Mm^Xm, Mm^Xm
Mm, Mm, Mm, Mm, Mm, Hh, Ds, Wwrt, Ww, Ww, Ww, Ww, Wwrt, Ds, Hh, Hh^Vhh, Ce, Ce, Ce, Hh, Ce, Re, Hh, Hh^Vhh, Gs^Fp, Gs^Fp, Gs^Fp, Gs^Fp, Gg^Ve, Hh, Hh, Hh, Mm, Rr^Vd, Mm^Xm, Mm^Xm, Mm
Mm, Mm, Mm, Mm, Mm, Hh, Hh, Ds, Ds, Ww, Ww, Wwrt, Ww, Ds, Ds, Hh, Hh, Gg, 3 Ke, Ce, Re, Re, Gs^Fp, Gg, Gs^Fp, Gs^Fp, Gg, Hh, Hh, Hh, Mm, Mm, Mm, Mm, Mm^Xm, Mm^Xm, Mm^Xm
Mm, Mm, Mm, Mm, Mm, Hh, Hh, Ds, Gs^Vc, Ds, Wwrt, Ww, Ww, Wwrt, Ww, Ds, Ds, Hh, Gs^Fp, Gg, Re, Gg^Fet, Gs^Fp, Gs^Fp, Gs^Fp, Hh, Hh, Gg, Hh, Hh, Mm, Mm, Mm, Mm, Mm, Mm^Xm, Mm^Xm
Mm, Mm, Mm, Mm, Mm, Mm, Mm, Hh, Ds, Ds, Wwrt, Ds, Ds, Ww, Ww, Ww, Ds, Hh, Gs^Fp, Hh^Vhh, Re, Gs^Fp, Gg, Hh, Gg, Hh, Hh, Hh, Mm, Mm, Mm, Mm, Mm, Mm, Mm, Mm, Mm
Mm, Mm, Mm, Mm, Mm, Mm, Mm, Hh, Ds, Ww, Ww, Ds, Gg, Ds, Ds, Ww, Ww, Ds, Ds, Gs^Fp, Re, Gs^Fp, Gs^Fp, Gg, Hh, Hh, Ds, Hh, Hh, Mm, Mm, Mm, Mm, Mm, Mm, Mm, Mm
Mm, Mm, Mm, Mm, Mm, Mm, Mm, Hh, Ds, Ww, Ww, Ds, Gg, Gg, Gg, Ds, Wwrt, Ww, Ww, Ds, Re, Gs^Fp, Gs^Fp, Gg, Gs^Fp, Ds, Ww, Ds, Ds, Hh, Hh, Hh, Hh, Mm, Mm, Mm, Mm
Mm, Rr^Vd, Mm, Mm, Mm, Mm, Mm, Gs^Vc, Ds, Ww, Ds, Ds, Gg, Gg, Ds, Ds, Ww, Ww, Ww, Wwrt, Ww^Bw|, Ds, Ds, Ds, Ds, Ds, Ww, Ww, Ww, Ds, Ds, Ds, Ds, Hh, Hh, Mm, Hh
Mm^Xm, Mm^Xm, Mm, Mm, Mm, Mm, Mm, Hh, Ds, Ww, Ds, Gg, Gg, Ds, Ww, Ww, Ww, Ww, Ds, Ww, Ww^Bw|, Ww, Ww, Ww, Ww, Wwrt, Ww, Ww, Ww, Ww, Ww, Ww, Ww, Ds, Ds, Hh, Ds
Mm^Xm, Mm^Xm, Mm^Xm, Mm, Mm, Mm, Mm, Hh, Ds, Ww, Ww, Ds, Ds, Ds, Ww, Ww, Ds, Ds, Gs, Ds, Re, Ww, Ww, Ww, Ww, Ww, Ww, Ww, Ww, Ww, Ww, Ww, Ww, Ww, Ww, Ds, Ww
Mm^Xm, Mm^Xm, Mm^Xm, Mm^Xm, Mm, Mm, Mm, Hh, Ds, Ww, Ww, Ww, Ww, Ww, Ww, Ww, Ds, Gs, Gg^Vh, Gs, Re, Ds, Ds, Ww, Ds, Ww, Ds, Ds, Ds, Ds, Ds, Ds, Ds, Ww, Ww, Ww, Ww
Mm^Xm, Mm^Xm, Mm^Xm, Mm^Xm, Mm^Xm, Mm, Mm, Hh, Hh, Ds, Ds, Ww, Ww, Ww, Ds, Ds, Gs, Gs, Gs, Gs, Re, Gs, Gs, Ds, Gs, Ds, Gs, Gs, Gs, Gg^Vh, Hh, Gs, Ds, Ww, Wwrt, Ww, Ww
Mm^Xm, Mm^Xm, Mm^Xm, Mm^Xm, Mm^Xm, Mm, Mm, Mm, Mm, Hh, Hh, Ds, Ds, Ds, Gs, Gs, Gs, Gs, Gs, Ce, Re, Gs, Gs, Gs, Gs, Gs, Hh, Hh, Hh, Hh, Mm, Hh, Hh, Ds, Ds, Ww, Ww
Mm^Xm, Mm^Xm, Mm^Xm, Mm^Xm, Mm, Mm, Mm, Mm, Mm, Mm, Mm, Hh, Gs, Gs, Gs, Gs, Gs, Ce, Ce, Ce, Ce, Ce, Gs, Gs, Hh, Hh, Mm, Mm, Mm, Mm, Mm, Mm, Mm, Hh, Hh, Ds, Ds
Mm^Xm, Mm^Xm, Mm^Xm, Mm^Xm, Mm, Mm, Mm, Mm, Mm, Mm, Mm, Hh, Gs, Gs, Gs, Gg^Vh, Gs, Gs, Re, 1 Ke, Gs, Gs, Gs, Hh, Mm, Mm, Mm, Mm, Mm^Xm, Mm, Mm^Xm, Mm, Mm, Mm, Mm, Rr^Vd, Gs
Mm, Mm^Xm, Mm, Mm, Mm, Mm, Mm, Mm, Mm, Mm, Gg, Hh, Gs, Gs, Gs, Gs, Re, Re, Gs, Gs, Gs, Gs, Gs, Hh, Mm, Mm, Mm, Mm^Xm, Mm^Xm, Mm^Xm, Gs, Mm, Mm, Mm, Mm, Hh, Gs
