Uh, Uh, Uh, Uh, Uh, Uh, Ur, Ur, Uhe, Uhe, Uhe, Uhe, Uhe, Uhe, Uhe, Urb, Qlf, Xu, Xu, Xu, Xu, Xu, Xu, Xu, Ur, Xu, Xu, Xu, Ur, Ur, Qxua, Qxua, Qxua, Qxua, Qxua, Qxua, Qxua, Qxua, Qxua, Qxua
Uh, Uh, Uh, Uh, Uh, Ur, Ur, Xu, Uhe, Uhe, Uhe, Uhe, Ur, Uhe, Uu^Vu, Urb, Xu, Xu, Xu, Xu, Xu, Xu, Xu, Xu, Ur, Ur, Xu, Xu, Xu, Ur, Ur, Qxua, Qxua, Qxua, Qxua, Qxua, Qxua, Qxua, Qxua, Qxua
Uh, Uh, Uh, Uh, Urb, Ur, Uhe, Uhe, Uhe, Uhe, Uhe, Uhe, Uhe, Uhe, Uhe, Urb, Ql, Xu, Xu, Xu, Xu, Xu, Qxu^Bsb/, Ur, Uhe, Uu^Vu, Xu, Xu, Ur, Ur, Ur, Qxua, Qxua, Qxua, Qxua, Qxua, Qxua, Qxua, Qxua, Qxua
Uh, Uh, Uh, Uh, Urb, Xu, Uhe, Xu, Uhe, Uhe, Uhe, Uhe, Uhe, Uhe, Uhe, Urb, Xu, Ql, Xu, Xu, Qlf^Bsb/, Ss^Bsb/, Uhe, Uhe, Uhe, Uhe, Uhe, Ur, Ur, Ur, Ur, Ur, Qxua, Qxua, Qxua, Qxua, Qxua, Qxua, Qxua, Qxua
Uh, Uh, Uh, Urb, Xu, Xu, Xu, Xu, Xu, Uhe, Uhe, Uhe, Uhe, Uhe, Uhe, Urb, Urb, Ql, Qlf^Bsb/, Qlf^Bsb/, Ql, Uhe, Uhe, Uhe, Uhe, Uhe, Ur, Ur, Ur, Xu, Xu, Ur, Ur, Qxua, Qxua, Qxua, Qxua, Qxua, Qxua, Qxua
Uh, Uh, Urb, Urb, Xu, Xu, Xu, Xu, Xu, Uu^Vu, Uhe, Uhe, Uhe, Uhe, Uhe, Uhe, Urb, Urb, Uhe, Uhe, Uhe, Uhe, Uhe, Uhe, Uhe, Uhe, Ur, Ur, Ur, Ur, Ur, Xu, Ur, Qxua, Qxua, Qxua, Qxua, Qxua, Qxua, Qxua
Uh, Uh, Urb, Xu, Xu, Xu, Xu, Uhe, Uhe, Uhe, Uhe, Uhe, Uhe, Uhe, Urb, Urb, Uhe, Uhe, Uhe, Uhe, Xu, Uhe, Uhe, Uhe, Uhe, Uhe, Ur, Ur, Ur, Uu^Vu, Ur, Ur, Ur, Ur, Qxua, Qxua, Qxua, Qxua, Qxua, Qxua
Uh, Uh, Urb, Xu, Xu, Xu, Xu, Xu, Uhe, Uhe, Uhe, Uhe, Uhe, Uhe, Urb, Uhe, Uhe, Uhe, Uhe, Qlf, Uhe, Uhe, Uhe, Uhe, Uhe, Ur, Xu, Ur, Ur, Ur, Ur, Ur, Ur, Ur, Ur, Qxua, Qxua, Qxua, Qxua, Qxua
Uh, Urb, Urb, Xu, Xu, Xu, Xu, Uu^Vu, Uhe, Uhe, Ur, Uhe, Uhe, Uhe, Urb, Uhe, Ur, Uhe, Uu^Vu, Qlf, Uhe, Uhe, Uhe, Uhe, Rr, Rr, Ur^Ii, Ur^Ii, Ur^Ii, Ur, Ur, Ur, Ur, Ur, Ur, Qxua, Qxua, Qxua, Qxua, Qxua
Uh, Uh, Urb, Xu, Xu, Xu, Xu, Uhe, Ur, Ur, Ur, Ur, Urb, Urb, Uue, Ur, Ur, Uhe, Uhe, Qlf, Qlf, Qlf, Rr, Rr, Uue^Ii, Ur^Ii, Qxua^Ii, Qxu^Bs|, Qxua^Ii, Ur^Ii, Ur^Ii, Ur, Xu, Ur, Ur, Ur, Qxua, Qxua, Qxua, Qxua
Urb, Urb, Uh, Uh, Xu, Xu, Uu^Vu, Xu, Ur, Ur, Urb, Urb, Ur, Uue, Uue, Ur, Ur, Xu, Xu, Uhe, Qlf, Ur, Ur, Uue, Uue^Ii, Qxu^Bs\, Qxu^Bs\, Qxu^Bs|, Qxu^Bs/, Qxu^Bs/, Ur^Ii, Xu, Xu, Xu, Xu, Ur, Ur, Qxua, Qxua, Qxua
Uh, Urb, Urb, Uh, Uh, Xu, Ur, Ur, Urb, Urb, Ur, Ur, Uue, Uue, Ur, Ur, Ur, Ur, Ur, Qlf, Qlf, Ur, Ur, Uue, Uue^Ii, Qxua^Ii, Qxu^Bs/, Urb^Ii, Qxu^Bs\, Qxua^Ii, Ur^Ii, Xu, Xu, Xu, Xu, Ur, Ur, Qxua, Qxua, Qxua
Uh, Uh, Uh, Urb, Urb, Xu, Urb, Urb, Ur, Ur, Ur, Ur, Ur, Uue, Ur, Ur, Ur, Ur, Ur, Qlf, Qlf, Qlf, Ur, Uue, Ur^Ii, Qxu^Bs/, Qxua^Ii, Qxu^Bs|, Qxua^Ii, Qxu^Bs\, Ur^Ii, Xu, Xu, Xu, Xu, Xu, Ur, Qxua, Qxua, Qxua
Uh, Uh, Uh, Uh, Urb, Urb, Urb, Uu^Vu, Ur, Ur, Ur, Ur, Ur, Ur, Ur, Ur, Uu^Vu, Ur, Ur, Qlf, Qlf, Uhe, Ur, Ur, Ur, Ur^Ii, Ur^Ii, Qxu^Bs|, Uu^Ii, Ur^Ii, Ur, Xu, Xu, Xu, Xu, Xu, Ur, Ur, Qxua, Qxua
Uh, Uh, Uh, Uh, Xu, Urb, Cud, Ur, Urb, Ur, Urb, Ur, Urb, Urb, Urb, Ur, Urb, Ur, Urb, Ur, Ur, Qlf, Qlf, Ur, Ur, Xu, Ur, Ur^Ii, Ur, Ur, Xu, Xu, Xu, Xu, Xu, Ur, Ur, Ur, Ur, Qxua
Uh, Uh, Uh, Xu, Xu, Cud, 1 Kud, Cud, Urb, Urb, Ur, Urb, Ur, Ur, Xu, Urb, Ur, Urb, Xu, Urb, Urb, Uhe, Qlf^Bsb/, Ur, Ur, Xu, Xu, Ur, Ur, Ur, Xu, Xu, Xu, Xu, Ur, Ur, Ur, Ur, Ur, Qxua
Uh, Uh, Uh, Xu, Ur, Cud, Cud, Cud, Uh, Urb, Ur, Ur, Ur, Ur, Xu, Xu, Xu, Xu, Xu, Ur, Xu, Urb, Qlf, Qlf, Uu^Vu, Ur, Ur, Ur, Ur, Ur, Uu^Vu, Xu, Xu, Ur, Uu^Vu, Ur, Ur, Ur, Ur, Qxua
Uh, Uh, Urb, Uh, Urb, Urb, Uh, Ur, Uh, Urb, Urb, Ur, Ur, Ur, Xu, Xu, Xu, Xu, Xu, Xu, Ur, Ur, Qlf, Qlf, Qlf, Ur, Ur, Ur, Ur, Ur, Xu, Xu, Ur, Ur, Ur, Ur, Ur, Ur, Ur, Ur
Uh, Urb, Uh, Urb, Uh, Uh, Xu, Ur, Cud, Uh, Urb, Ur, Ur, Ur, Ur, Ur, Ur, Xu, Xu, Xu, Ur, Ur, Qlf, Ql, Qlf, Ur, Ur, Ur, Ur, Ur, Ur, Ur, Ur, Ur, Ur, Ur, Ur, Ur, Qxua, Ur
Uh, Uh, Uh, Uh, Uh, Uh, Xu, Cud, 2 Kud, Cud, Uh, Urb, Uh, Ur, Ur, Ur, Ur, Xu, Xu, Xu, Ur, Ur, Qlf, Ql, Ql, Qlf, Ur, Ur, Ur, Ur, Uue, Ur, Qxua^Cov, Qxua^Cov, Qxua^Cov, Ur, Ur, Qxua, Qxua, Qxua
Uh, Uh, Ur, Uh, Xu, Xu, Uh, Cud, Cud, Cud, Uh, Urb, Urb, Ur, Ur, Ur, Ur, Uu^Vu, Ur, Ur, Ur, Ur, Ur, Qlf, Qlf, Qlf, Qlf, Ur, Ur, Uue, Uue, Ur, Qxua^Cov, 3 Qxua^Kov, Qxua^Cov, Ur, Ur, Qxua, Qxua, Qxua
Uh, Uh, Uh, Ur, Uh, Uh, Uh, Ur, Ur, Ur, Ur, Uh, Urb, Uh, Uh, Ur, Ur, Ur, Ur, Ur, Ur, Ur, Ur, Ur, Qlf, Qlf, Qlf, Ur, Ur, Uu^Vu, Uue, Ur, Ur, Qxua^Cov, Ur, Ur, Ur, Ur, Qxua, Qxua
Xue, Uh, Uh, Uh, Uh, Uh, Uu^Vu, Uh, Uh, Uh, Uh, Uh, Urb, Urb, Uh, Ur, Ur, Ur, Ur, Xu, Xu, Ur, Ur, Ur, Ur, Qlf, Ql^Bsb/, Qlf^Bsb/, Ur, Uue, Uue, Uue, Ur, Ur, Xu, Uu^Vu, Ur, Ur, Ur, Qxua
Xue, Xue, Uh, Uh, Uh, Uh, Xu, Xu, Uh, Uh, Ur, Uh, Uh, Urb, Uh, Qxua, Ur, Ur, Ur, Xu, Xu, Ur, Ur, Ur, Ur, Qlf^Bsb/, Qlf, Qlf, Ur, Uue, Uue, Uue, Ur, Ur, Xu, Ur, Ur, Ur, Ur, Qxua
Xue, Xue, Xue, Uh, Uh, Uh, Ur, Uh, Uh, Uh, Xu, Uu^Vu, Xu, Urb, Uh, Qxua, Qxua, Ur, Ur, Ur, Xu, Xu, Ur, Ur, Ur, Ur, Qlf, Qlf, Qlf, Ur^Bsb|, Qlf, Qlf, Ur, Ur, Ur, Ur, Ur, Ur, Ur, Ur
Xue, Xue, Xue, Xue, Uh, Uh, Uh, Uh, Uh, Uh, Xu, Xu, Uh, Urb, Uh, Qxua, Ur, Ur, Ur, Ur, Ur, Xu, Ur, Ur, Ur, Ur, Ql, Qlf, Qlf, Wwf^Bsb|, Qlf, Ql, Ql, Uhe, Uhe, Uhe, Uhe, Ur, Ur, Ur
Xue, Xue, Xue, Xue, Uh, Uh, Uh, Ur, Ur, Ur, Uh, Uh, Urb, Urb, Uh, Uh, Uh, Ur, Ur, Uu^Vu, Ur, Ur, Ur, Ur, Ur, Uhe, Ql, Ql, Wwf, Uue, Qlf, Ql, Ql, Uhe, Ql, Uhe, Uhe, Ur, Ur, Ur
Xue, Xue, Xue, Xue, Xue, Uh, Uh, Uh, Uh, Uh, Uh, Uh, Urb, Uh, Xu, Uh, Uh, Ur, Ur, Ur, Ur, Ur, Ur, Ur, Uhe, Qlf, Qlf, Qlf, Uue, Uue, Ql, Ql, Ql, Ql, Ql, Qlf, Uhe, Uhe, Ur, Ur
Xue, Xue, Xue, Xue, Xue, Xue, Uh, Uh, Uh, Uh, Uh, Uh, Urb, Uh, Uu^Vu, Xu, Uh, Uh, Uh, Ur, Ur, Ur, Ur, Uhe, Uhe, Ql, Ql^Bsb/, Qlf^Bsb/, Qlf, Ql, Ql, Ql, Ql, Ql, Qlf, Qlf, Uhe, Uhe, Ur, Ur
Xue, Xue, Xue, Xue, Xue, Xue, Uh, Uh, Uh, Uh, Uh, Uh, Urb, Uh, Xu, Xu, Uh, Uh, Uh, Uh, Uh, Ur, Ur, Uhe, Uhe, Uhe, Qlf, Qlf, Ql, Ql, Ql, Ql, Ql, Ql, Qlf, Uhe, Ur, Ur, Ur, Ur
Xue, Xue, Xue, Xue, Xue, Xue, Xue, Uh, Uh, Uh, Xu, Uh, Uh, Urb, Urb, Uh, Uh, Uh, Uh, Uh, Uh, Xu, Xu, Ur, Ur, Ur, Ur, Qlf, Qlf, Ql, Ql, Ql, Ql, Ql, Ur, Ur, Ur, Ur, Ur, Qxua
Xue, Xue, Xue, Xue, Xue, Xue, Xue, Xue, Uh, Uh, Xu, Xu, Xu, Uh, Uh, Urb, Uh, Ur, Xu, Uu^Vu, Cfr, Uh, Uh, Uu^Vu, Ur, Ur, Ur, Ur, Uhe, Qlf, Qlf, Qlf, Ur, Ur, Ur, Ur, Ur, Qxua, Qxua, Qxua
Xue, Xue, Xue, Xue, Xue, Xue, Xue, Xue, Xue, Uh, Uh, Xu, Xu, Uu^Vu, Uh, Urb, Uh, Uh, Xu, Cfr, 4 Kfr, Cfr, Cfr, Uh, Ur, Ur, Ur, Ur, Ur, Qlf, Qlf, Qlf, Ur, Ur, Ur, Ur, Ur, Qxua, Qxua, Qxua
Xue, Xue, Xue, Xue, Xue, Xue, Xue, Xue, Xue, Uu^Vu, Uh, Uh, Uh, Uh, Ur, Urb, Uh, Xu, Xu, Cfr, Cfr, Cfr, Uh, Uh, Urb, Urb, Urb, Ur, Ur, Ur, Qlf, Qlf, Ur, Ur, Ur, Ur, Qxua, Qxua, Qxua, Qxua
Xue, Xue, Xue, Xue, Xue, Xue, Xue, Xue, Xue, Uh, Uh, Uh, Uh, Uh, Uh, Ur, Urb, Uh, Xu, Xu, Uh, Uh, Urb, Urb, Uh, Ur, Uu^Vu, Urb, Ur, Ur, Qlf, Ur, Ur, Ur, Ur, Ur, Qxua, Qxua, Qxua, Qxua
Xue, Xue, Xue, Xue, Xue, Xue, Xue, Xue, Xue, Xue, Xue, Uh, Uh, Uh, Uh, Uh, Uh, Urb, Urb, Uh, Urb, Urb, Uh, Uh, Uh, Xu, Xu, Urb, Ur, Qlf, Ur, Ur, Ur, Ur, Qxua, Qxua, Qxua, Qxua, Qxua, Qxua
Xue, Xue, Xue, Xue, Xue, Xue, Xue, Xue, Xue, Xue, Xue, Uh, Uh, Uh, Uh, Uh, Uh, Uh, Uh, Urb, Uh, Uh, Uh, Uh, Uh, Xu, Xu, Urb, Qlf, Qlf, Ur, Ur, Ur, Qxua, Qxua, Qxua, Qxua, Qxua, Qxua, Qxua
